dep;week;clage_covid;nb_test;nb_pos;nb_test_h;nb_pos_h;nb_test_f;nb_pos_f
01;2020-S11;0;0;0;0;0;0;0
01;2020-S11;A;0;0;0;0;0;0
01;2020-S11;B;0;0;0;0;0;0
01;2020-S11;C;0;0;0;0;0;0
01;2020-S11;D;0;0;0;0;0;0
01;2020-S11;E;0;0;0;0;0;0
01;2020-S12;0;193;39;59;20;134;19
01;2020-S12;A;2;0;0;0;2;0
01;2020-S12;B;94;9;20;7;74;2
01;2020-S12;C;45;15;12;6;33;9
01;2020-S12;D;18;10;10;6;8;4
01;2020-S12;E;34;5;17;1;17;4
01;2020-S13;0;144;26;42;11;102;15
01;2020-S13;A;3;0;2;0;1;0
01;2020-S13;B;71;13;12;3;59;10
01;2020-S13;C;45;6;16;3;29;3
01;2020-S13;D;13;5;7;3;6;2
01;2020-S13;E;12;2;5;2;7;0
01;2020-S14;0;215;37;68;14;147;23
01;2020-S14;A;1;0;0;0;1;0
01;2020-S14;B;86;14;18;4;68;10
01;2020-S14;C;80;12;30;4;50;8
01;2020-S14;D;20;2;6;0;14;2
01;2020-S14;E;28;9;14;6;14;3
01;2020-S15;0;314;59;101;16;213;43
01;2020-S15;A;10;0;2;0;8;0
01;2020-S15;B;121;23;39;5;82;18
01;2020-S15;C;116;24;37;6;79;18
01;2020-S15;D;33;5;11;3;22;2
01;2020-S15;E;34;7;12;2;22;5
01;2020-S16;0;864;143;213;41;651;102
01;2020-S16;A;6;0;3;0;3;0
01;2020-S16;B;308;34;68;5;240;29
01;2020-S16;C;263;30;54;6;209;24
01;2020-S16;D;55;12;24;7;31;5
01;2020-S16;E;232;67;64;23;168;44
01;2020-S17;0;491;50;160;12;331;38
01;2020-S17;A;7;0;4;0;3;0
01;2020-S17;B;177;14;56;4;121;10
01;2020-S17;C;144;10;43;2;101;8
01;2020-S17;D;31;3;14;1;17;2
01;2020-S17;E;132;23;43;5;89;18
01;2020-S18;0;295;8;60;2;235;6
01;2020-S18;A;3;0;3;0;0;0
01;2020-S18;B;99;4;16;0;83;4
01;2020-S18;C;107;3;24;2;83;1
01;2020-S18;D;21;0;8;0;13;0
01;2020-S18;E;65;1;9;0;56;1
01;2020-S19;0;398;5;109;1;289;4
01;2020-S19;A;4;0;1;0;3;0
01;2020-S19;B;124;4;29;1;95;3
01;2020-S19;C;96;0;27;0;69;0
01;2020-S19;D;20;0;9;0;11;0
01;2020-S19;E;151;1;43;0;108;1
01;2020-S20;0;342;12;151;2;191;10
01;2020-S20;A;29;1;12;0;17;1
01;2020-S20;B;121;3;64;1;57;2
01;2020-S20;C;82;2;40;1;42;1
01;2020-S20;D;36;0;21;0;15;0
01;2020-S20;E;74;6;14;0;60;6
01;2020-S21;0;246;3;102;1;144;2
01;2020-S21;A;31;0;15;0;16;0
01;2020-S21;B;95;3;33;1;62;2
01;2020-S21;C;66;0;27;0;39;0
01;2020-S21;D;26;0;12;0;14;0
01;2020-S21;E;28;0;15;0;13;0
02;2020-S11;0;0;0;0;0;0;0
02;2020-S11;A;0;0;0;0;0;0
02;2020-S11;B;0;0;0;0;0;0
02;2020-S11;C;0;0;0;0;0;0
02;2020-S11;D;0;0;0;0;0;0
02;2020-S11;E;0;0;0;0;0;0
02;2020-S12;0;21;7;13;3;8;4
02;2020-S12;A;0;0;0;0;0;0
02;2020-S12;B;1;0;1;0;0;0
02;2020-S12;C;8;3;5;2;3;1
02;2020-S12;D;1;1;0;0;1;1
02;2020-S12;E;11;3;7;1;4;2
02;2020-S13;0;108;39;33;15;75;24
02;2020-S13;A;0;0;0;0;0;0
02;2020-S13;B;34;11;9;3;25;8
02;2020-S13;C;44;14;14;6;30;8
02;2020-S13;D;8;6;5;4;3;2
02;2020-S13;E;22;8;5;2;17;6
02;2020-S14;0;351;129;119;38;232;91
02;2020-S14;A;5;0;3;0;2;0
02;2020-S14;B;110;31;30;8;80;23
02;2020-S14;C;107;28;47;9;60;19
02;2020-S14;D;35;10;13;4;22;6
02;2020-S14;E;93;60;26;17;67;43
02;2020-S15;0;464;126;136;38;328;88
02;2020-S15;A;6;1;0;0;6;1
02;2020-S15;B;177;33;43;5;134;28
02;2020-S15;C;136;40;45;13;91;27
02;2020-S15;D;35;9;15;5;20;4
02;2020-S15;E;110;43;33;15;77;28
02;2020-S16;0;371;51;124;15;247;36
02;2020-S16;A;4;1;4;1;0;0
02;2020-S16;B;131;17;38;4;93;13
02;2020-S16;C;88;14;37;6;51;8
02;2020-S16;D;28;3;13;1;15;2
02;2020-S16;E;120;16;32;3;88;13
02;2020-S17;0;471;51;142;13;329;38
02;2020-S17;A;4;0;3;0;1;0
02;2020-S17;B;143;9;35;3;108;6
02;2020-S17;C;126;12;38;3;88;9
02;2020-S17;D;46;3;30;1;16;2
02;2020-S17;E;150;27;34;6;116;21
02;2020-S18;0;228;20;56;6;172;14
02;2020-S18;A;2;0;1;0;1;0
02;2020-S18;B;93;4;19;1;74;3
02;2020-S18;C;62;4;14;0;48;4
02;2020-S18;D;13;3;9;2;4;1
02;2020-S18;E;58;9;13;3;45;6
02;2020-S19;0;440;12;110;3;330;9
02;2020-S19;A;6;0;2;0;4;0
02;2020-S19;B;114;3;32;2;82;1
02;2020-S19;C;84;3;23;1;61;2
02;2020-S19;D;32;1;12;0;20;1
02;2020-S19;E;204;5;41;0;163;5
02;2020-S20;0;320;15;94;4;226;11
02;2020-S20;A;9;0;3;0;6;0
02;2020-S20;B;122;7;35;2;87;5
02;2020-S20;C;83;3;31;0;52;3
02;2020-S20;D;24;1;7;1;17;0
02;2020-S20;E;82;4;18;1;64;3
02;2020-S21;0;221;2;76;1;145;1
02;2020-S21;A;14;0;7;0;7;0
02;2020-S21;B;96;1;30;1;66;0
02;2020-S21;C;57;0;19;0;38;0
02;2020-S21;D;22;1;10;0;12;1
02;2020-S21;E;32;0;10;0;22;0
03;2020-S11;0;0;0;0;0;0;0
03;2020-S11;A;0;0;0;0;0;0
03;2020-S11;B;0;0;0;0;0;0
03;2020-S11;C;0;0;0;0;0;0
03;2020-S11;D;0;0;0;0;0;0
03;2020-S11;E;0;0;0;0;0;0
03;2020-S12;0;5;0;4;0;1;0
03;2020-S12;A;0;0;0;0;0;0
03;2020-S12;B;0;0;0;0;0;0
03;2020-S12;C;1;0;1;0;0;0
03;2020-S12;D;1;0;0;0;1;0
03;2020-S12;E;3;0;3;0;0;0
03;2020-S13;0;5;1;3;1;2;0
03;2020-S13;A;0;0;0;0;0;0
03;2020-S13;B;4;1;2;1;2;0
03;2020-S13;C;0;0;0;0;0;0
03;2020-S13;D;0;0;0;0;0;0
03;2020-S13;E;1;0;1;0;0;0
03;2020-S14;0;26;0;7;0;19;0
03;2020-S14;A;0;0;0;0;0;0
03;2020-S14;B;6;0;1;0;5;0
03;2020-S14;C;12;0;3;0;9;0
03;2020-S14;D;2;0;0;0;2;0
03;2020-S14;E;6;0;3;0;3;0
03;2020-S15;0;29;3;11;0;18;3
03;2020-S15;A;0;0;0;0;0;0
03;2020-S15;B;8;0;4;0;4;0
03;2020-S15;C;8;0;4;0;4;0
03;2020-S15;D;5;0;3;0;2;0
03;2020-S15;E;8;3;0;0;8;3
03;2020-S16;0;61;0;16;0;45;0
03;2020-S16;A;0;0;0;0;0;0
03;2020-S16;B;31;0;7;0;24;0
03;2020-S16;C;25;0;7;0;18;0
03;2020-S16;D;1;0;1;0;0;0
03;2020-S16;E;4;0;1;0;3;0
03;2020-S17;0;7;0;3;0;4;0
03;2020-S17;A;0;0;0;0;0;0
03;2020-S17;B;5;0;1;0;4;0
03;2020-S17;C;0;0;0;0;0;0
03;2020-S17;D;1;0;1;0;0;0
03;2020-S17;E;1;0;1;0;0;0
03;2020-S18;0;78;1;36;0;42;1
03;2020-S18;A;2;0;0;0;2;0
03;2020-S18;B;20;0;11;0;9;0
03;2020-S18;C;22;0;9;0;13;0
03;2020-S18;D;16;1;6;0;10;1
03;2020-S18;E;18;0;10;0;8;0
03;2020-S19;0;155;1;77;0;78;1
03;2020-S19;A;3;0;1;0;2;0
03;2020-S19;B;48;0;22;0;26;0
03;2020-S19;C;43;0;20;0;23;0
03;2020-S19;D;32;0;18;0;14;0
03;2020-S19;E;29;1;16;0;13;1
03;2020-S20;0;391;1;200;1;191;0
03;2020-S20;A;7;0;2;0;5;0
03;2020-S20;B;117;0;55;0;62;0
03;2020-S20;C;131;1;74;1;57;0
03;2020-S20;D;71;0;36;0;35;0
03;2020-S20;E;64;0;32;0;32;0
03;2020-S21;0;281;5;136;4;145;1
03;2020-S21;A;17;0;3;0;14;0
03;2020-S21;B;89;4;47;3;42;1
03;2020-S21;C;92;1;47;1;45;0
03;2020-S21;D;45;0;20;0;25;0
03;2020-S21;E;37;0;18;0;19;0
04;2020-S11;0;0;0;0;0;0;0
04;2020-S11;A;0;0;0;0;0;0
04;2020-S11;B;0;0;0;0;0;0
04;2020-S11;C;0;0;0;0;0;0
04;2020-S11;D;0;0;0;0;0;0
04;2020-S11;E;0;0;0;0;0;0
04;2020-S12;0;1;0;0;0;1;0
04;2020-S12;A;0;0;0;0;0;0
04;2020-S12;B;0;0;0;0;0;0
04;2020-S12;C;0;0;0;0;0;0
04;2020-S12;D;0;0;0;0;0;0
04;2020-S12;E;1;0;0;0;1;0
04;2020-S13;0;97;11;25;2;72;9
04;2020-S13;A;2;1;2;1;0;0
04;2020-S13;B;30;3;5;0;25;3
04;2020-S13;C;33;4;9;1;24;3
04;2020-S13;D;14;1;5;0;9;1
04;2020-S13;E;18;2;4;0;14;2
04;2020-S14;0;180;15;78;6;102;9
04;2020-S14;A;2;0;2;0;0;0
04;2020-S14;B;70;4;28;1;42;3
04;2020-S14;C;72;8;32;3;40;5
04;2020-S14;D;23;1;11;0;12;1
04;2020-S14;E;13;2;5;2;8;0
04;2020-S15;0;139;5;52;2;87;3
04;2020-S15;A;4;0;0;0;4;0
04;2020-S15;B;58;0;24;0;34;0
04;2020-S15;C;49;5;16;2;33;3
04;2020-S15;D;16;0;11;0;5;0
04;2020-S15;E;12;0;1;0;11;0
04;2020-S16;0;252;14;66;4;186;10
04;2020-S16;A;3;1;2;1;1;0
04;2020-S16;B;73;3;21;1;52;2
04;2020-S16;C;71;3;17;1;54;2
04;2020-S16;D;17;1;5;0;12;1
04;2020-S16;E;88;6;21;1;67;5
04;2020-S17;0;192;4;77;3;115;1
04;2020-S17;A;5;0;0;0;5;0
04;2020-S17;B;55;2;22;2;33;0
04;2020-S17;C;53;2;22;1;31;1
04;2020-S17;D;24;0;14;0;10;0
04;2020-S17;E;55;0;19;0;36;0
04;2020-S18;0;303;7;81;3;222;4
04;2020-S18;A;4;0;2;0;2;0
04;2020-S18;B;81;1;15;0;66;1
04;2020-S18;C;91;4;20;1;71;3
04;2020-S18;D;19;1;10;1;9;0
04;2020-S18;E;108;1;34;1;74;0
04;2020-S19;0;144;3;43;2;101;1
04;2020-S19;A;6;0;6;0;0;0
04;2020-S19;B;41;1;6;1;35;0
04;2020-S19;C;48;2;13;1;35;1
04;2020-S19;D;19;0;10;0;9;0
04;2020-S19;E;30;0;8;0;22;0
04;2020-S20;0;233;4;86;1;147;3
04;2020-S20;A;11;0;8;0;3;0
04;2020-S20;B;80;1;29;0;51;1
04;2020-S20;C;77;2;25;0;52;2
04;2020-S20;D;27;0;10;0;17;0
04;2020-S20;E;37;1;13;1;24;0
04;2020-S21;0;105;0;47;0;58;0
04;2020-S21;A;7;0;3;0;4;0
04;2020-S21;B;30;0;12;0;18;0
04;2020-S21;C;23;0;11;0;12;0
04;2020-S21;D;17;0;9;0;8;0
04;2020-S21;E;28;0;12;0;16;0
05;2020-S11;0;0;0;0;0;0;0
05;2020-S11;A;0;0;0;0;0;0
05;2020-S11;B;0;0;0;0;0;0
05;2020-S11;C;0;0;0;0;0;0
05;2020-S11;D;0;0;0;0;0;0
05;2020-S11;E;0;0;0;0;0;0
05;2020-S12;0;1;0;1;0;0;0
05;2020-S12;A;0;0;0;0;0;0
05;2020-S12;B;0;0;0;0;0;0
05;2020-S12;C;0;0;0;0;0;0
05;2020-S12;D;0;0;0;0;0;0
05;2020-S12;E;1;0;1;0;0;0
05;2020-S13;0;4;0;3;0;1;0
05;2020-S13;A;0;0;0;0;0;0
05;2020-S13;B;1;0;0;0;1;0
05;2020-S13;C;3;0;3;0;0;0
05;2020-S13;D;0;0;0;0;0;0
05;2020-S13;E;0;0;0;0;0;0
05;2020-S14;0;36;1;7;0;29;1
05;2020-S14;A;0;0;0;0;0;0
05;2020-S14;B;15;0;3;0;12;0
05;2020-S14;C;16;1;2;0;14;1
05;2020-S14;D;2;0;1;0;1;0
05;2020-S14;E;3;0;1;0;2;0
05;2020-S15;0;40;1;11;1;29;0
05;2020-S15;A;0;0;0;0;0;0
05;2020-S15;B;16;0;4;0;12;0
05;2020-S15;C;16;1;6;1;10;0
05;2020-S15;D;5;0;1;0;4;0
05;2020-S15;E;3;0;0;0;3;0
05;2020-S16;0;28;1;12;1;16;0
05;2020-S16;A;1;0;1;0;0;0
05;2020-S16;B;7;0;1;0;6;0
05;2020-S16;C;10;1;4;1;6;0
05;2020-S16;D;5;0;3;0;2;0
05;2020-S16;E;5;0;3;0;2;0
05;2020-S17;0;179;1;38;0;141;1
05;2020-S17;A;0;0;0;0;0;0
05;2020-S17;B;55;1;11;0;44;1
05;2020-S17;C;36;0;7;0;29;0
05;2020-S17;D;6;0;2;0;4;0
05;2020-S17;E;82;0;18;0;64;0
05;2020-S18;0;28;0;10;0;18;0
05;2020-S18;A;0;0;0;0;0;0
05;2020-S18;B;8;0;4;0;4;0
05;2020-S18;C;8;0;3;0;5;0
05;2020-S18;D;4;0;2;0;2;0
05;2020-S18;E;8;0;1;0;7;0
05;2020-S19;0;158;0;47;0;111;0
05;2020-S19;A;2;0;2;0;0;0
05;2020-S19;B;47;0;8;0;39;0
05;2020-S19;C;30;0;13;0;17;0
05;2020-S19;D;8;0;2;0;6;0
05;2020-S19;E;71;0;22;0;49;0
05;2020-S20;0;71;0;30;0;41;0
05;2020-S20;A;3;0;1;0;2;0
05;2020-S20;B;24;0;11;0;13;0
05;2020-S20;C;21;0;8;0;13;0
05;2020-S20;D;13;0;5;0;8;0
05;2020-S20;E;10;0;5;0;5;0
05;2020-S21;0;65;0;28;0;37;0
05;2020-S21;A;5;0;2;0;3;0
05;2020-S21;B;21;0;10;0;11;0
05;2020-S21;C;16;0;5;0;11;0
05;2020-S21;D;13;0;7;0;6;0
05;2020-S21;E;10;0;4;0;6;0
06;2020-S11;0;34;0;13;0;21;0
06;2020-S11;A;1;0;0;0;1;0
06;2020-S11;B;16;0;6;0;10;0
06;2020-S11;C;12;0;4;0;8;0
06;2020-S11;D;4;0;3;0;1;0
06;2020-S11;E;0;0;0;0;0;0
06;2020-S12;0;162;24;60;13;102;11
06;2020-S12;A;3;0;0;0;3;0
06;2020-S12;B;70;5;26;3;44;2
06;2020-S12;C;52;8;17;4;35;4
06;2020-S12;D;13;5;6;3;7;2
06;2020-S12;E;20;6;10;3;10;3
06;2020-S13;0;540;60;199;28;341;32
06;2020-S13;A;1;0;0;0;1;0
06;2020-S13;B;214;19;68;9;146;10
06;2020-S13;C;179;17;63;6;116;11
06;2020-S13;D;71;15;39;8;32;7
06;2020-S13;E;72;9;29;5;43;4
06;2020-S14;0;979;86;351;39;628;47
06;2020-S14;A;11;1;7;1;4;0
06;2020-S14;B;431;27;137;7;294;20
06;2020-S14;C;349;28;126;13;223;15
06;2020-S14;D;85;15;35;8;50;7
06;2020-S14;E;100;15;44;10;56;5
06;2020-S15;0;1145;65;267;19;878;46
06;2020-S15;A;0;0;0;0;0;0
06;2020-S15;B;498;8;103;2;395;6
06;2020-S15;C;358;15;90;5;268;10
06;2020-S15;D;45;8;17;4;28;4
06;2020-S15;E;241;34;57;8;184;26
06;2020-S16;0;1211;17;295;5;916;12
06;2020-S16;A;1;0;0;0;1;0
06;2020-S16;B;308;6;68;2;240;4
06;2020-S16;C;268;8;68;3;200;5
06;2020-S16;D;54;0;18;0;36;0
06;2020-S16;E;579;3;141;0;438;3
06;2020-S17;0;446;9;138;5;308;4
06;2020-S17;A;2;0;0;0;2;0
06;2020-S17;B;100;3;40;1;60;2
06;2020-S17;C;89;4;35;2;54;2
06;2020-S17;D;27;1;8;1;19;0
06;2020-S17;E;228;1;55;1;173;0
06;2020-S18;0;123;1;46;1;77;0
06;2020-S18;A;2;0;0;0;2;0
06;2020-S18;B;32;1;11;1;21;0
06;2020-S18;C;33;0;17;0;16;0
06;2020-S18;D;16;0;8;0;8;0
06;2020-S18;E;40;0;10;0;30;0
06;2020-S19;0;39;1;20;1;19;0
06;2020-S19;A;2;0;1;0;1;0
06;2020-S19;B;13;0;6;0;7;0
06;2020-S19;C;14;0;9;0;5;0
06;2020-S19;D;6;1;3;1;3;0
06;2020-S19;E;4;0;1;0;3;0
06;2020-S20;0;250;0;66;0;183;0
06;2020-S20;A;6;0;1;0;4;0
06;2020-S20;B;82;0;23;0;59;0
06;2020-S20;C;55;0;11;0;44;0
06;2020-S20;D;25;0;12;0;13;0
06;2020-S20;E;71;0;15;0;56;0
06;2020-S21;0;652;0;198;0;454;0
06;2020-S21;A;3;0;0;0;3;0
06;2020-S21;B;175;0;58;0;117;0
06;2020-S21;C;178;0;59;0;119;0
06;2020-S21;D;41;0;15;0;26;0
06;2020-S21;E;251;0;64;0;187;0
07;2020-S11;0;0;0;0;0;0;0
07;2020-S11;A;0;0;0;0;0;0
07;2020-S11;B;0;0;0;0;0;0
07;2020-S11;C;0;0;0;0;0;0
07;2020-S11;D;0;0;0;0;0;0
07;2020-S11;E;0;0;0;0;0;0
07;2020-S12;0;119;34;40;16;79;18
07;2020-S12;A;0;0;0;0;0;0
07;2020-S12;B;50;10;12;3;38;7
07;2020-S12;C;39;11;11;4;28;7
07;2020-S12;D;8;5;7;5;1;0
07;2020-S12;E;22;8;10;4;12;4
07;2020-S13;0;46;15;18;4;28;11
07;2020-S13;A;0;0;0;0;0;0
07;2020-S13;B;13;5;3;0;10;5
07;2020-S13;C;16;4;6;2;10;2
07;2020-S13;D;4;3;2;1;2;2
07;2020-S13;E;13;3;7;1;6;2
07;2020-S14;0;46;15;15;6;31;9
07;2020-S14;A;0;0;0;0;0;0
07;2020-S14;B;9;1;2;1;7;0
07;2020-S14;C;16;5;4;0;12;5
07;2020-S14;D;6;2;2;0;4;2
07;2020-S14;E;15;7;7;5;8;2
07;2020-S15;0;100;18;30;6;70;12
07;2020-S15;A;1;0;0;0;1;0
07;2020-S15;B;29;2;4;1;25;1
07;2020-S15;C;43;7;14;1;29;6
07;2020-S15;D;10;3;6;3;4;0
07;2020-S15;E;17;6;6;1;11;5
07;2020-S16;0;122;26;46;12;76;14
07;2020-S16;A;0;0;0;0;0;0
07;2020-S16;B;29;0;5;0;24;0
07;2020-S16;C;31;7;13;3;18;4
07;2020-S16;D;9;2;6;2;3;0
07;2020-S16;E;53;17;22;7;31;10
07;2020-S17;0;69;6;28;2;41;4
07;2020-S17;A;2;0;1;0;1;0
07;2020-S17;B;17;0;3;0;14;0
07;2020-S17;C;19;1;11;1;8;0
07;2020-S17;D;4;0;1;0;3;0
07;2020-S17;E;27;5;12;1;15;4
07;2020-S18;0;137;6;40;2;97;4
07;2020-S18;A;3;0;3;0;0;0
07;2020-S18;B;46;3;13;1;33;2
07;2020-S18;C;54;1;10;1;44;0
07;2020-S18;D;5;0;2;0;3;0
07;2020-S18;E;24;2;10;0;14;2
07;2020-S19;0;413;2;130;2;283;0
07;2020-S19;A;1;0;0;0;1;0
07;2020-S19;B;86;2;27;2;59;0
07;2020-S19;C;66;0;22;0;44;0
07;2020-S19;D;42;0;26;0;16;0
07;2020-S19;E;218;0;55;0;163;0
07;2020-S20;0;74;1;27;0;47;1
07;2020-S20;A;2;0;2;0;0;0
07;2020-S20;B;29;0;7;0;22;0
07;2020-S20;C;22;0;8;0;14;0
07;2020-S20;D;11;0;6;0;5;0
07;2020-S20;E;10;1;4;0;6;1
07;2020-S21;0;53;0;28;0;24;0
07;2020-S21;A;3;0;0;0;3;0
07;2020-S21;B;25;0;17;0;7;0
07;2020-S21;C;14;0;8;0;6;0
07;2020-S21;D;4;0;1;0;3;0
07;2020-S21;E;7;0;2;0;5;0
08;2020-S11;0;0;0;0;0;0;0
08;2020-S11;A;0;0;0;0;0;0
08;2020-S11;B;0;0;0;0;0;0
08;2020-S11;C;0;0;0;0;0;0
08;2020-S11;D;0;0;0;0;0;0
08;2020-S11;E;0;0;0;0;0;0
08;2020-S12;0;7;1;3;0;4;1
08;2020-S12;A;0;0;0;0;0;0
08;2020-S12;B;3;1;2;0;1;1
08;2020-S12;C;2;0;1;0;1;0
08;2020-S12;D;0;0;0;0;0;0
08;2020-S12;E;2;0;0;0;2;0
08;2020-S13;0;63;11;23;5;40;6
08;2020-S13;A;1;0;0;0;1;0
08;2020-S13;B;35;5;11;2;24;3
08;2020-S13;C;20;6;8;3;12;3
08;2020-S13;D;0;0;0;0;0;0
08;2020-S13;E;7;0;4;0;3;0
08;2020-S14;0;143;19;55;6;88;13
08;2020-S14;A;2;0;1;0;1;0
08;2020-S14;B;65;5;23;1;42;4
08;2020-S14;C;51;9;18;2;33;7
08;2020-S14;D;12;2;7;2;5;0
08;2020-S14;E;13;3;6;1;7;2
08;2020-S15;0;178;23;62;9;116;14
08;2020-S15;A;6;0;3;0;3;0
08;2020-S15;B;57;3;11;1;46;2
08;2020-S15;C;65;3;25;0;40;3
08;2020-S15;D;17;3;10;3;7;0
08;2020-S15;E;33;14;13;5;20;9
08;2020-S16;0;199;16;63;7;136;9
08;2020-S16;A;3;0;1;0;2;0
08;2020-S16;B;96;2;30;1;66;1
08;2020-S16;C;70;6;20;3;50;3
08;2020-S16;D;14;2;5;1;9;1
08;2020-S16;E;16;6;7;2;9;4
08;2020-S17;0;264;11;81;4;183;7
08;2020-S17;A;3;0;2;0;1;0
08;2020-S17;B;142;1;36;1;106;0
08;2020-S17;C;93;8;30;3;63;5
08;2020-S17;D;12;1;5;0;7;1
08;2020-S17;E;14;1;8;0;6;1
08;2020-S18;0;145;4;64;2;81;2
08;2020-S18;A;1;0;0;0;1;0
08;2020-S18;B;55;0;22;0;33;0
08;2020-S18;C;48;0;24;0;24;0
08;2020-S18;D;12;1;7;1;5;0
08;2020-S18;E;29;3;11;1;18;2
08;2020-S19;0;94;9;40;4;54;5
08;2020-S19;A;1;0;0;0;1;0
08;2020-S19;B;36;2;13;0;23;2
08;2020-S19;C;35;3;19;2;16;1
08;2020-S19;D;13;1;5;1;8;0
08;2020-S19;E;9;3;3;1;6;2
08;2020-S20;0;24;7;11;3;13;4
08;2020-S20;A;0;0;0;0;0;0
08;2020-S20;B;7;0;4;0;3;0
08;2020-S20;C;7;1;3;1;4;0
08;2020-S20;D;4;1;3;1;1;0
08;2020-S20;E;6;5;1;1;5;4
08;2020-S21;0;0;0;0;0;0;0
08;2020-S21;A;0;0;0;0;0;0
08;2020-S21;B;0;0;0;0;0;0
08;2020-S21;C;0;0;0;0;0;0
08;2020-S21;D;0;0;0;0;0;0
08;2020-S21;E;0;0;0;0;0;0
09;2020-S11;0;0;0;0;0;0;0
09;2020-S11;A;0;0;0;0;0;0
09;2020-S11;B;0;0;0;0;0;0
09;2020-S11;C;0;0;0;0;0;0
09;2020-S11;D;0;0;0;0;0;0
09;2020-S11;E;0;0;0;0;0;0
09;2020-S12;0;6;2;1;0;5;2
09;2020-S12;A;0;0;0;0;0;0
09;2020-S12;B;5;2;0;0;5;2
09;2020-S12;C;0;0;0;0;0;0
09;2020-S12;D;0;0;0;0;0;0
09;2020-S12;E;1;0;1;0;0;0
09;2020-S13;0;7;0;3;0;4;0
09;2020-S13;A;1;0;0;0;1;0
09;2020-S13;B;3;0;0;0;3;0
09;2020-S13;C;2;0;2;0;0;0
09;2020-S13;D;1;0;1;0;0;0
09;2020-S13;E;0;0;0;0;0;0
09;2020-S14;0;21;3;10;2;11;1
09;2020-S14;A;0;0;0;0;0;0
09;2020-S14;B;9;1;4;0;5;1
09;2020-S14;C;10;2;6;2;4;0
09;2020-S14;D;1;0;0;0;1;0
09;2020-S14;E;1;0;0;0;1;0
09;2020-S15;0;85;2;24;0;61;2
09;2020-S15;A;1;0;1;0;0;0
09;2020-S15;B;33;1;10;0;23;1
09;2020-S15;C;39;1;9;0;30;1
09;2020-S15;D;5;0;3;0;2;0
09;2020-S15;E;6;0;0;0;6;0
09;2020-S16;0;95;0;30;0;65;0
09;2020-S16;A;1;0;0;0;1;0
09;2020-S16;B;36;0;9;0;27;0
09;2020-S16;C;50;0;17;0;33;0
09;2020-S16;D;5;0;2;0;3;0
09;2020-S16;E;3;0;2;0;1;0
09;2020-S17;0;12;0;3;0;9;0
09;2020-S17;A;0;0;0;0;0;0
09;2020-S17;B;7;0;1;0;6;0
09;2020-S17;C;0;0;0;0;0;0
09;2020-S17;D;2;0;1;0;1;0
09;2020-S17;E;3;0;1;0;2;0
09;2020-S18;0;12;0;3;0;9;0
09;2020-S18;A;0;0;0;0;0;0
09;2020-S18;B;7;0;2;0;5;0
09;2020-S18;C;3;0;0;0;3;0
09;2020-S18;D;1;0;1;0;0;0
09;2020-S18;E;1;0;0;0;1;0
09;2020-S19;0;516;0;105;0;411;0
09;2020-S19;A;2;0;1;0;1;0
09;2020-S19;B;141;0;24;0;117;0
09;2020-S19;C;99;0;16;0;83;0
09;2020-S19;D;22;0;8;0;14;0
09;2020-S19;E;252;0;56;0;196;0
09;2020-S20;0;51;0;19;0;32;0
09;2020-S20;A;4;0;3;0;1;0
09;2020-S20;B;18;0;6;0;12;0
09;2020-S20;C;18;0;9;0;9;0
09;2020-S20;D;3;0;0;0;3;0
09;2020-S20;E;8;0;1;0;7;0
09;2020-S21;0;51;0;20;0;31;0
09;2020-S21;A;4;0;1;0;3;0
09;2020-S21;B;21;0;9;0;12;0
09;2020-S21;C;11;0;4;0;7;0
09;2020-S21;D;5;0;2;0;3;0
09;2020-S21;E;7;0;3;0;4;0
10;2020-S11;0;7;0;3;0;4;0
10;2020-S11;A;0;0;0;0;0;0
10;2020-S11;B;1;0;0;0;1;0
10;2020-S11;C;1;0;0;0;1;0
10;2020-S11;D;2;0;2;0;0;0
10;2020-S11;E;3;0;1;0;2;0
10;2020-S12;0;40;7;13;1;27;6
10;2020-S12;A;1;0;0;0;1;0
10;2020-S12;B;20;4;4;1;16;3
10;2020-S12;C;13;3;5;0;8;3
10;2020-S12;D;4;0;2;0;2;0
10;2020-S12;E;2;0;2;0;0;0
10;2020-S13;0;238;54;63;19;175;35
10;2020-S13;A;6;0;1;0;5;0
10;2020-S13;B;117;27;22;6;95;21
10;2020-S13;C;74;17;18;5;56;12
10;2020-S13;D;12;3;5;3;7;0
10;2020-S13;E;29;7;17;5;12;2
10;2020-S14;0;413;82;126;28;287;54
10;2020-S14;A;2;1;0;0;2;1
10;2020-S14;B;204;35;51;9;153;26
10;2020-S14;C;141;29;42;11;99;18
10;2020-S14;D;29;8;17;4;12;4
10;2020-S14;E;35;9;14;4;21;5
10;2020-S15;0;503;110;193;30;310;80
10;2020-S15;A;8;1;5;1;3;0
10;2020-S15;B;209;36;84;7;125;29
10;2020-S15;C;169;35;61;10;108;25
10;2020-S15;D;49;12;20;4;29;8
10;2020-S15;E;68;26;23;8;45;18
10;2020-S16;0;307;56;82;17;225;39
10;2020-S16;A;5;0;2;0;3;0
10;2020-S16;B;128;20;45;8;83;12
10;2020-S16;C;99;17;22;6;77;11
10;2020-S16;D;10;1;4;0;6;1
10;2020-S16;E;65;18;9;3;56;15
10;2020-S17;0;506;33;136;9;370;24
10;2020-S17;A;8;0;4;0;4;0
10;2020-S17;B;218;11;48;3;170;8
10;2020-S17;C;204;11;57;2;147;9
10;2020-S17;D;26;1;12;1;14;0
10;2020-S17;E;50;10;15;3;35;7
10;2020-S18;0;540;15;139;7;401;8
10;2020-S18;A;8;1;4;1;4;0
10;2020-S18;B;250;2;58;1;192;1
10;2020-S18;C;209;8;43;2;166;6
10;2020-S18;D;20;1;13;1;7;0
10;2020-S18;E;53;3;21;2;32;1
10;2020-S19;0;651;4;126;2;525;2
10;2020-S19;A;3;0;2;0;1;0
10;2020-S19;B;280;4;41;2;239;2
10;2020-S19;C;220;0;41;0;179;0
10;2020-S19;D;27;0;7;0;20;0
10;2020-S19;E;121;0;35;0;86;0
10;2020-S20;0;375;6;119;2;256;4
10;2020-S20;A;7;1;3;1;4;0
10;2020-S20;B;102;2;34;0;68;2
10;2020-S20;C;84;1;25;0;59;1
10;2020-S20;D;28;0;16;0;12;0
10;2020-S20;E;154;2;41;1;113;1
10;2020-S21;0;210;2;63;0;147;2
10;2020-S21;A;6;0;3;0;3;0
10;2020-S21;B;71;1;26;0;45;1
10;2020-S21;C;52;1;12;0;40;1
10;2020-S21;D;21;0;5;0;16;0
10;2020-S21;E;60;0;17;0;43;0
11;2020-S11;0;1;0;0;0;1;0
11;2020-S11;A;0;0;0;0;0;0
11;2020-S11;B;1;0;0;0;1;0
11;2020-S11;C;0;0;0;0;0;0
11;2020-S11;D;0;0;0;0;0;0
11;2020-S11;E;0;0;0;0;0;0
11;2020-S12;0;70;11;22;6;48;5
11;2020-S12;A;0;0;0;0;0;0
11;2020-S12;B;25;4;7;2;18;2
11;2020-S12;C;22;2;4;1;18;1
11;2020-S12;D;4;0;2;0;2;0
11;2020-S12;E;17;3;7;1;10;2
11;2020-S13;0;276;43;100;19;176;24
11;2020-S13;A;4;0;2;0;2;0
11;2020-S13;B;95;11;25;6;70;5
11;2020-S13;C;96;16;40;6;56;10
11;2020-S13;D;31;5;17;3;14;2
11;2020-S13;E;49;11;16;4;33;7
11;2020-S14;0;339;47;120;20;219;27
11;2020-S14;A;4;0;1;0;3;0
11;2020-S14;B;140;12;49;4;91;8
11;2020-S14;C;106;9;33;4;73;5
11;2020-S14;D;40;11;19;5;21;6
11;2020-S14;E;49;15;18;7;31;8
11;2020-S15;0;413;54;129;19;283;35
11;2020-S15;A;1;0;0;0;0;0
11;2020-S15;B;154;5;34;2;120;3
11;2020-S15;C;134;7;38;3;96;4
11;2020-S15;D;48;8;25;4;23;4
11;2020-S15;E;71;33;30;10;41;23
11;2020-S16;0;414;5;106;0;304;5
11;2020-S16;A;6;0;1;0;1;0
11;2020-S16;B;119;0;28;0;91;0
11;2020-S16;C;119;1;27;0;92;1
11;2020-S16;D;23;1;14;0;9;1
11;2020-S16;E;147;3;36;0;111;3
11;2020-S17;0;377;10;125;4;245;6
11;2020-S17;A;8;0;1;0;0;0
11;2020-S17;B;113;5;39;2;74;3
11;2020-S17;C;96;3;34;1;62;2
11;2020-S17;D;38;1;19;1;19;0
11;2020-S17;E;122;1;32;0;90;1
11;2020-S18;0;195;6;52;1;142;5
11;2020-S18;A;1;0;0;0;0;0
11;2020-S18;B;43;3;12;1;31;2
11;2020-S18;C;51;1;11;0;40;1
11;2020-S18;D;17;0;6;0;11;0
11;2020-S18;E;83;2;23;0;60;2
11;2020-S19;0;301;3;105;1;189;2
11;2020-S19;A;11;0;2;0;2;0
11;2020-S19;B;67;2;31;1;36;1
11;2020-S19;C;80;1;28;0;52;1
11;2020-S19;D;35;0;15;0;20;0
11;2020-S19;E;108;0;29;0;79;0
11;2020-S20;0;381;1;142;0;230;1
11;2020-S20;A;7;0;0;0;0;0
11;2020-S20;B;126;0;54;0;70;0
11;2020-S20;C;98;0;34;0;64;0
11;2020-S20;D;48;0;21;0;27;0
11;2020-S20;E;101;1;33;0;68;1
11;2020-S21;0;382;1;155;1;205;0
11;2020-S21;A;22;0;2;0;3;0
11;2020-S21;B;133;1;59;1;69;0
11;2020-S21;C;112;0;41;0;71;0
11;2020-S21;D;61;0;26;0;35;0
11;2020-S21;E;52;0;27;0;25;0
12;2020-S11;0;0;0;0;0;0;0
12;2020-S11;A;0;0;0;0;0;0
12;2020-S11;B;0;0;0;0;0;0
12;2020-S11;C;0;0;0;0;0;0
12;2020-S11;D;0;0;0;0;0;0
12;2020-S11;E;0;0;0;0;0;0
12;2020-S12;0;2;1;0;0;2;1
12;2020-S12;A;0;0;0;0;0;0
12;2020-S12;B;1;0;0;0;1;0
12;2020-S12;C;1;1;0;0;1;1
12;2020-S12;D;0;0;0;0;0;0
12;2020-S12;E;0;0;0;0;0;0
12;2020-S13;0;9;1;2;0;7;1
12;2020-S13;A;0;0;0;0;0;0
12;2020-S13;B;3;0;0;0;3;0
12;2020-S13;C;5;1;1;0;4;1
12;2020-S13;D;1;0;1;0;0;0
12;2020-S13;E;0;0;0;0;0;0
12;2020-S14;0;9;1;1;0;8;1
12;2020-S14;A;0;0;0;0;0;0
12;2020-S14;B;4;1;0;0;4;1
12;2020-S14;C;3;0;0;0;3;0
12;2020-S14;D;1;0;1;0;0;0
12;2020-S14;E;1;0;0;0;1;0
12;2020-S15;0;9;0;3;0;6;0
12;2020-S15;A;0;0;0;0;0;0
12;2020-S15;B;4;0;2;0;2;0
12;2020-S15;C;2;0;0;0;2;0
12;2020-S15;D;3;0;1;0;2;0
12;2020-S15;E;0;0;0;0;0;0
12;2020-S16;0;6;0;0;0;6;0
12;2020-S16;A;0;0;0;0;0;0
12;2020-S16;B;2;0;0;0;2;0
12;2020-S16;C;2;0;0;0;2;0
12;2020-S16;D;1;0;0;0;1;0
12;2020-S16;E;1;0;0;0;1;0
12;2020-S17;0;17;2;9;0;8;2
12;2020-S17;A;0;0;0;0;0;0
12;2020-S17;B;4;0;3;0;1;0
12;2020-S17;C;6;0;3;0;3;0
12;2020-S17;D;0;0;0;0;0;0
12;2020-S17;E;7;2;3;0;4;2
12;2020-S18;0;5;0;4;0;1;0
12;2020-S18;A;0;0;0;0;0;0
12;2020-S18;B;0;0;0;0;0;0
12;2020-S18;C;3;0;2;0;1;0
12;2020-S18;D;1;0;1;0;0;0
12;2020-S18;E;1;0;1;0;0;0
12;2020-S19;0;10;0;5;0;5;0
12;2020-S19;A;0;0;0;0;0;0
12;2020-S19;B;1;0;1;0;0;0
12;2020-S19;C;5;0;3;0;2;0
12;2020-S19;D;1;0;1;0;0;0
12;2020-S19;E;3;0;0;0;3;0
12;2020-S20;0;19;0;9;0;10;0
12;2020-S20;A;0;0;0;0;0;0
12;2020-S20;B;4;0;1;0;3;0
12;2020-S20;C;9;0;6;0;3;0
12;2020-S20;D;2;0;1;0;1;0
12;2020-S20;E;4;0;1;0;3;0
12;2020-S21;0;22;0;7;0;15;0
12;2020-S21;A;0;0;0;0;0;0
12;2020-S21;B;9;0;3;0;6;0
12;2020-S21;C;6;0;1;0;5;0
12;2020-S21;D;3;0;1;0;2;0
12;2020-S21;E;4;0;2;0;2;0
13;2020-S11;0;14;1;3;1;11;0
13;2020-S11;A;2;0;1;0;1;0
13;2020-S11;B;6;1;1;1;5;0
13;2020-S11;C;3;0;1;0;2;0
13;2020-S11;D;2;0;0;0;2;0
13;2020-S11;E;1;0;0;0;1;0
13;2020-S12;0;559;78;202;23;357;55
13;2020-S12;A;22;0;13;0;9;0
13;2020-S12;B;254;33;83;10;171;23
13;2020-S12;C;172;33;54;9;118;24
13;2020-S12;D;52;8;31;3;21;5
13;2020-S12;E;59;4;21;1;38;3
13;2020-S13;0;4538;839;1680;370;2853;469
13;2020-S13;A;64;5;30;2;30;3
13;2020-S13;B;1858;328;586;118;1271;210
13;2020-S13;C;1615;329;604;152;1011;177
13;2020-S13;D;499;94;248;52;251;42
13;2020-S13;E;491;80;207;45;284;35
13;2020-S14;0;5577;673;2031;258;3525;409
13;2020-S14;A;109;14;43;5;49;3
13;2020-S14;B;2177;231;692;74;1481;157
13;2020-S14;C;2072;248;743;97;1329;151
13;2020-S14;D;574;64;289;30;285;34
13;2020-S14;E;636;115;259;51;377;64
13;2020-S15;0;7306;707;2386;254;4903;451
13;2020-S15;A;87;4;28;2;46;1
13;2020-S15;B;2394;149;738;50;1652;98
13;2020-S15;C;2051;187;733;77;1318;110
13;2020-S15;D;678;78;319;47;359;31
13;2020-S15;E;2054;287;559;78;1495;209
13;2020-S16;0;8484;375;2407;134;6077;241
13;2020-S16;A;94;4;43;2;51;2
13;2020-S16;B;2382;77;683;25;1699;52
13;2020-S16;C;2104;78;648;25;1456;53
13;2020-S16;D;668;48;304;29;364;19
13;2020-S16;E;3218;168;725;53;2493;115
13;2020-S17;0;6075;204;2019;76;4056;128
13;2020-S17;A;86;4;45;3;41;1
13;2020-S17;B;1873;54;605;11;1268;43
13;2020-S17;C;1692;43;572;16;1120;27
13;2020-S17;D;616;22;294;16;322;6
13;2020-S17;E;1797;81;500;30;1297;51
13;2020-S18;0;4537;106;1489;36;3047;70
13;2020-S18;A;72;2;40;2;31;0
13;2020-S18;B;1402;29;442;6;960;23
13;2020-S18;C;1281;30;423;11;858;19
13;2020-S18;D;476;10;231;4;245;6
13;2020-S18;E;1305;35;353;13;952;22
13;2020-S19;0;5453;104;1757;32;3694;72
13;2020-S19;A;129;2;61;1;66;1
13;2020-S19;B;1744;22;568;8;1176;14
13;2020-S19;C;1617;17;532;6;1085;11
13;2020-S19;D;508;16;232;5;276;11
13;2020-S19;E;1454;47;364;12;1090;35
13;2020-S20;0;5368;53;2111;16;3255;37
13;2020-S20;A;139;0;76;0;63;0
13;2020-S20;B;1685;7;681;2;1003;5
13;2020-S20;C;1459;9;601;5;858;4
13;2020-S20;D;541;5;280;2;260;3
13;2020-S20;E;1531;32;462;7;1069;25
13;2020-S21;0;3666;34;1500;6;2165;28
13;2020-S21;A;160;0;89;0;71;0
13;2020-S21;B;1335;5;550;1;784;4
13;2020-S21;C;1097;7;438;1;659;6
13;2020-S21;D;408;3;196;0;212;3
13;2020-S21;E;666;19;227;4;439;15
14;2020-S11;0;4;1;2;1;2;0
14;2020-S11;A;0;0;0;0;0;0
14;2020-S11;B;2;0;1;0;1;0
14;2020-S11;C;1;0;0;0;1;0
14;2020-S11;D;0;0;0;0;0;0
14;2020-S11;E;1;1;1;1;0;0
14;2020-S12;0;73;6;31;2;42;4
14;2020-S12;A;1;0;1;0;0;0
14;2020-S12;B;24;0;7;0;17;0
14;2020-S12;C;24;3;11;1;13;2
14;2020-S12;D;7;0;5;0;2;0
14;2020-S12;E;17;3;7;1;10;2
14;2020-S13;0;278;55;75;15;203;40
14;2020-S13;A;2;0;0;0;2;0
14;2020-S13;B;125;28;25;5;100;23
14;2020-S13;C;88;17;24;5;64;12
14;2020-S13;D;25;5;15;3;10;2
14;2020-S13;E;38;5;11;2;27;3
14;2020-S14;0;256;39;96;18;160;21
14;2020-S14;A;0;0;0;0;0;0
14;2020-S14;B;119;17;37;12;82;5
14;2020-S14;C;70;8;27;1;43;7
14;2020-S14;D;34;5;19;3;15;2
14;2020-S14;E;33;9;13;2;20;7
14;2020-S15;0;442;38;154;11;288;27
14;2020-S15;A;5;0;3;0;2;0
14;2020-S15;B;174;23;61;8;113;15
14;2020-S15;C;101;9;33;2;68;7
14;2020-S15;D;43;1;22;0;21;1
14;2020-S15;E;118;5;35;1;83;4
14;2020-S16;0;230;14;81;4;149;10
14;2020-S16;A;4;0;4;0;0;0
14;2020-S16;B;93;4;35;1;58;3
14;2020-S16;C;85;3;27;1;58;2
14;2020-S16;D;18;3;9;1;9;2
14;2020-S16;E;29;4;6;1;23;3
14;2020-S17;0;99;2;41;1;58;1
14;2020-S17;A;0;0;0;0;0;0
14;2020-S17;B;31;0;10;0;21;0
14;2020-S17;C;29;1;14;1;15;0
14;2020-S17;D;20;0;12;0;8;0
14;2020-S17;E;19;1;5;0;14;1
14;2020-S18;0;53;1;22;1;31;0
14;2020-S18;A;0;0;0;0;0;0
14;2020-S18;B;22;0;8;0;14;0
14;2020-S18;C;16;0;6;0;10;0
14;2020-S18;D;6;0;2;0;4;0
14;2020-S18;E;9;1;6;1;3;0
14;2020-S19;0;73;1;22;0;51;1
14;2020-S19;A;4;1;2;0;2;1
14;2020-S19;B;36;0;12;0;24;0
14;2020-S19;C;25;0;6;0;19;0
14;2020-S19;D;5;0;1;0;4;0
14;2020-S19;E;3;0;1;0;2;0
14;2020-S20;0;104;0;47;0;57;0
14;2020-S20;A;3;0;1;0;2;0
14;2020-S20;B;42;0;18;0;24;0
14;2020-S20;C;35;0;20;0;15;0
14;2020-S20;D;13;0;5;0;8;0
14;2020-S20;E;11;0;3;0;8;0
14;2020-S21;0;57;0;21;0;36;0
14;2020-S21;A;4;0;3;0;1;0
14;2020-S21;B;17;0;4;0;13;0
14;2020-S21;C;26;0;10;0;16;0
14;2020-S21;D;4;0;1;0;3;0
14;2020-S21;E;6;0;3;0;3;0
15;2020-S11;0;0;0;0;0;0;0
15;2020-S11;A;0;0;0;0;0;0
15;2020-S11;B;0;0;0;0;0;0
15;2020-S11;C;0;0;0;0;0;0
15;2020-S11;D;0;0;0;0;0;0
15;2020-S11;E;0;0;0;0;0;0
15;2020-S12;0;4;0;3;0;1;0
15;2020-S12;A;0;0;0;0;0;0
15;2020-S12;B;1;0;0;0;1;0
15;2020-S12;C;2;0;2;0;0;0
15;2020-S12;D;1;0;1;0;0;0
15;2020-S12;E;0;0;0;0;0;0
15;2020-S13;0;42;6;18;3;23;3
15;2020-S13;A;0;0;0;0;0;0
15;2020-S13;B;10;5;4;2;6;3
15;2020-S13;C;7;1;3;1;3;0
15;2020-S13;D;4;0;1;0;3;0
15;2020-S13;E;21;0;10;0;11;0
15;2020-S14;0;44;4;14;0;30;4
15;2020-S14;A;1;0;0;0;1;0
15;2020-S14;B;16;1;2;0;14;1
15;2020-S14;C;13;2;4;0;9;2
15;2020-S14;D;4;1;3;0;1;1
15;2020-S14;E;10;0;5;0;5;0
15;2020-S15;0;38;2;15;0;22;2
15;2020-S15;A;0;0;0;0;0;0
15;2020-S15;B;14;1;1;0;12;1
15;2020-S15;C;7;0;5;0;2;0
15;2020-S15;D;3;0;3;0;0;0
15;2020-S15;E;14;1;6;0;8;1
15;2020-S16;0;56;11;20;2;34;8
15;2020-S16;A;0;0;0;0;0;0
15;2020-S16;B;12;2;4;0;6;1
15;2020-S16;C;19;4;6;1;13;3
15;2020-S16;D;8;1;4;0;4;1
15;2020-S16;E;17;4;6;1;11;3
15;2020-S17;0;84;7;39;2;44;5
15;2020-S17;A;2;0;0;0;2;0
15;2020-S17;B;18;1;8;0;9;1
15;2020-S17;C;22;1;8;0;14;1
15;2020-S17;D;16;2;10;1;6;1
15;2020-S17;E;26;3;13;1;13;2
15;2020-S18;0;43;2;21;1;21;1
15;2020-S18;A;2;0;1;0;0;0
15;2020-S18;B;11;0;4;0;7;0
15;2020-S18;C;11;1;4;0;7;1
15;2020-S18;D;6;0;4;0;2;0
15;2020-S18;E;13;1;8;1;5;0
15;2020-S19;0;48;9;17;1;30;8
15;2020-S19;A;0;0;0;0;0;0
15;2020-S19;B;19;3;5;1;13;2
15;2020-S19;C;10;2;4;0;6;2
15;2020-S19;D;8;2;4;0;4;2
15;2020-S19;E;11;2;4;0;7;2
15;2020-S20;0;133;1;68;1;63;0
15;2020-S20;A;5;0;2;0;2;0
15;2020-S20;B;60;0;30;0;29;0
15;2020-S20;C;37;1;20;1;17;0
15;2020-S20;D;12;0;5;0;7;0
15;2020-S20;E;19;0;11;0;8;0
15;2020-S21;0;83;2;41;1;42;1
15;2020-S21;A;2;0;1;0;1;0
15;2020-S21;B;27;2;10;1;17;1
15;2020-S21;C;20;0;9;0;11;0
15;2020-S21;D;18;0;13;0;5;0
15;2020-S21;E;16;0;8;0;8;0
16;2020-S11;0;0;0;0;0;0;0
16;2020-S11;A;0;0;0;0;0;0
16;2020-S11;B;0;0;0;0;0;0
16;2020-S11;C;0;0;0;0;0;0
16;2020-S11;D;0;0;0;0;0;0
16;2020-S11;E;0;0;0;0;0;0
16;2020-S12;0;2;0;1;0;1;0
16;2020-S12;A;0;0;0;0;0;0
16;2020-S12;B;2;0;1;0;1;0
16;2020-S12;C;0;0;0;0;0;0
16;2020-S12;D;0;0;0;0;0;0
16;2020-S12;E;0;0;0;0;0;0
16;2020-S13;0;22;4;5;1;17;3
16;2020-S13;A;0;0;0;0;0;0
16;2020-S13;B;12;1;3;1;9;0
16;2020-S13;C;9;2;2;0;7;2
16;2020-S13;D;1;1;0;0;1;1
16;2020-S13;E;0;0;0;0;0;0
16;2020-S14;0;75;6;20;3;55;3
16;2020-S14;A;1;0;0;0;1;0
16;2020-S14;B;33;0;7;0;26;0
16;2020-S14;C;30;4;9;2;21;2
16;2020-S14;D;7;0;2;0;5;0
16;2020-S14;E;4;2;2;1;2;1
16;2020-S15;0;98;9;39;7;58;2
16;2020-S15;A;4;0;2;0;2;0
16;2020-S15;B;44;4;14;3;29;1
16;2020-S15;C;30;1;12;1;18;0
16;2020-S15;D;11;3;7;3;4;0
16;2020-S15;E;8;1;4;0;4;1
16;2020-S16;0;106;1;24;1;82;0
16;2020-S16;A;0;0;0;0;0;0
16;2020-S16;B;57;0;10;0;47;0
16;2020-S16;C;35;1;8;1;27;0
16;2020-S16;D;6;0;2;0;4;0
16;2020-S16;E;8;0;4;0;4;0
16;2020-S17;0;221;0;79;0;142;0
16;2020-S17;A;1;0;1;0;0;0
16;2020-S17;B;52;0;12;0;40;0
16;2020-S17;C;44;0;15;0;29;0
16;2020-S17;D;29;0;19;0;10;0
16;2020-S17;E;95;0;32;0;63;0
16;2020-S18;0;37;0;18;0;19;0
16;2020-S18;A;2;0;1;0;1;0
16;2020-S18;B;15;0;8;0;7;0
16;2020-S18;C;13;0;5;0;8;0
16;2020-S18;D;3;0;2;0;1;0
16;2020-S18;E;4;0;2;0;2;0
16;2020-S19;0;44;0;16;0;28;0
16;2020-S19;A;2;0;1;0;1;0
16;2020-S19;B;15;0;3;0;12;0
16;2020-S19;C;18;0;12;0;6;0
16;2020-S19;D;3;0;0;0;3;0
16;2020-S19;E;6;0;0;0;6;0
16;2020-S20;0;121;1;47;0;74;1
16;2020-S20;A;6;0;3;0;3;0
16;2020-S20;B;41;0;19;0;22;0
16;2020-S20;C;41;1;11;0;30;1
16;2020-S20;D;12;0;3;0;9;0
16;2020-S20;E;21;0;11;0;10;0
16;2020-S21;0;111;0;59;0;52;0
16;2020-S21;A;8;0;6;0;2;0
16;2020-S21;B;33;0;19;0;14;0
16;2020-S21;C;35;0;17;0;18;0
16;2020-S21;D;12;0;9;0;3;0
16;2020-S21;E;23;0;8;0;15;0
17;2020-S11;0;3;0;2;0;1;0
17;2020-S11;A;1;0;1;0;0;0
17;2020-S11;B;2;0;1;0;1;0
17;2020-S11;C;0;0;0;0;0;0
17;2020-S11;D;0;0;0;0;0;0
17;2020-S11;E;0;0;0;0;0;0
17;2020-S12;0;37;4;13;0;24;4
17;2020-S12;A;1;0;0;0;1;0
17;2020-S12;B;13;1;4;0;9;1
17;2020-S12;C;17;3;5;0;12;3
17;2020-S12;D;2;0;2;0;0;0
17;2020-S12;E;4;0;2;0;2;0
17;2020-S13;0;248;21;74;7;174;14
17;2020-S13;A;2;0;0;0;2;0
17;2020-S13;B;108;7;28;2;80;5
17;2020-S13;C;96;9;27;2;69;7
17;2020-S13;D;21;4;12;3;9;1
17;2020-S13;E;21;1;7;0;14;1
17;2020-S14;0;377;29;115;13;262;16
17;2020-S14;A;6;0;4;0;2;0
17;2020-S14;B;159;9;44;3;115;6
17;2020-S14;C;142;12;35;7;107;5
17;2020-S14;D;36;4;18;1;18;3
17;2020-S14;E;34;4;14;2;20;2
17;2020-S15;0;795;22;234;5;561;17
17;2020-S15;A;10;0;5;0;5;0
17;2020-S15;B;221;11;57;1;164;10
17;2020-S15;C;232;6;57;1;175;5
17;2020-S15;D;52;2;27;1;25;1
17;2020-S15;E;252;3;80;2;172;1
17;2020-S16;0;1693;56;411;16;1282;40
17;2020-S16;A;9;0;6;0;3;0
17;2020-S16;B;556;10;107;1;449;9
17;2020-S16;C;523;8;119;0;404;8
17;2020-S16;D;94;4;52;2;42;2
17;2020-S16;E;509;34;126;13;383;21
17;2020-S17;0;1412;14;375;4;1037;10
17;2020-S17;A;12;0;6;0;6;0
17;2020-S17;B;383;4;102;2;281;2
17;2020-S17;C;345;3;100;0;245;3
17;2020-S17;D;78;1;29;0;49;1
17;2020-S17;E;587;6;138;2;449;4
17;2020-S18;0;1489;9;413;5;1076;4
17;2020-S18;A;21;0;15;0;6;0
17;2020-S18;B;363;4;97;3;266;1
17;2020-S18;C;351;1;89;0;262;1
17;2020-S18;D;75;1;26;1;49;0
17;2020-S18;E;677;3;186;1;491;2
17;2020-S19;0;625;2;198;1;427;1
17;2020-S19;A;14;0;7;0;7;0
17;2020-S19;B;192;0;60;0;132;0
17;2020-S19;C;173;1;45;0;128;1
17;2020-S19;D;45;1;25;1;20;0
17;2020-S19;E;201;0;61;0;140;0
17;2020-S20;0;689;7;247;2;442;5
17;2020-S20;A;33;0;19;0;14;0
17;2020-S20;B;230;1;85;0;145;1
17;2020-S20;C;176;0;63;0;113;0
17;2020-S20;D;74;1;33;1;41;0
17;2020-S20;E;176;5;47;1;129;4
17;2020-S21;0;500;2;196;1;304;1
17;2020-S21;A;35;0;23;0;12;0
17;2020-S21;B;153;0;63;0;90;0
17;2020-S21;C;133;1;46;1;87;0
17;2020-S21;D;51;0;22;0;29;0
17;2020-S21;E;125;1;41;0;84;1
18;2020-S11;0;3;0;1;0;2;0
18;2020-S11;A;0;0;0;0;0;0
18;2020-S11;B;3;0;1;0;2;0
18;2020-S11;C;0;0;0;0;0;0
18;2020-S11;D;0;0;0;0;0;0
18;2020-S11;E;0;0;0;0;0;0
18;2020-S12;0;61;18;16;6;45;12
18;2020-S12;A;2;0;0;0;2;0
18;2020-S12;B;27;5;7;2;20;3
18;2020-S12;C;17;8;2;2;15;6
18;2020-S12;D;5;2;2;1;3;1
18;2020-S12;E;10;3;5;1;5;2
18;2020-S13;0;255;79;85;41;170;38
18;2020-S13;A;2;0;1;0;1;0
18;2020-S13;B;94;14;16;2;78;12
18;2020-S13;C;77;24;24;12;53;12
18;2020-S13;D;26;16;18;13;8;3
18;2020-S13;E;56;25;26;14;30;11
18;2020-S14;0;256;58;83;18;173;40
18;2020-S14;A;1;0;1;0;0;0
18;2020-S14;B;92;11;20;3;72;8
18;2020-S14;C;60;15;21;2;39;13
18;2020-S14;D;30;6;14;3;16;3
18;2020-S14;E;73;26;27;10;46;16
18;2020-S15;0;237;72;56;13;181;59
18;2020-S15;A;0;0;0;0;0;0
18;2020-S15;B;95;23;25;5;70;18
18;2020-S15;C;84;13;16;0;68;13
18;2020-S15;D;7;3;4;2;3;1
18;2020-S15;E;51;33;11;6;40;27
18;2020-S16;0;269;38;65;8;204;30
18;2020-S16;A;1;0;0;0;1;0
18;2020-S16;B;118;11;25;0;93;11
18;2020-S16;C;110;17;24;5;86;12
18;2020-S16;D;12;2;6;1;6;1
18;2020-S16;E;28;8;10;2;18;6
18;2020-S17;0;372;27;82;8;290;19
18;2020-S17;A;3;0;0;0;3;0
18;2020-S17;B;156;10;25;2;131;8
18;2020-S17;C;116;7;25;1;91;6
18;2020-S17;D;17;1;6;1;11;0
18;2020-S17;E;79;9;26;4;53;5
18;2020-S18;0;417;10;106;0;311;10
18;2020-S18;A;5;0;2;0;3;0
18;2020-S18;B;139;4;29;0;110;4
18;2020-S18;C;121;2;29;0;92;2
18;2020-S18;D;25;1;13;0;12;1
18;2020-S18;E;127;3;33;0;94;3
18;2020-S19;0;474;18;184;4;290;14
18;2020-S19;A;3;0;1;0;2;0
18;2020-S19;B;166;5;59;1;107;4
18;2020-S19;C;139;3;49;1;90;2
18;2020-S19;D;69;0;36;0;33;0
18;2020-S19;E;97;10;39;2;58;8
18;2020-S20;0;416;5;184;2;232;3
18;2020-S20;A;21;0;11;0;10;0
18;2020-S20;B;150;1;62;1;88;0
18;2020-S20;C;128;0;50;0;78;0
18;2020-S20;D;49;2;26;1;23;1
18;2020-S20;E;68;2;35;0;33;2
18;2020-S21;0;294;8;115;3;179;5
18;2020-S21;A;12;0;3;0;9;0
18;2020-S21;B;81;1;31;0;50;1
18;2020-S21;C;54;1;24;0;30;1
18;2020-S21;D;33;1;17;1;16;0
18;2020-S21;E;114;5;40;2;74;3
19;2020-S11;0;1;0;1;0;0;0
19;2020-S11;A;0;0;0;0;0;0
19;2020-S11;B;0;0;0;0;0;0
19;2020-S11;C;0;0;0;0;0;0
19;2020-S11;D;1;0;1;0;0;0
19;2020-S11;E;0;0;0;0;0;0
19;2020-S12;0;4;0;2;0;2;0
19;2020-S12;A;0;0;0;0;0;0
19;2020-S12;B;0;0;0;0;0;0
19;2020-S12;C;3;0;1;0;2;0
19;2020-S12;D;0;0;0;0;0;0
19;2020-S12;E;1;0;1;0;0;0
19;2020-S13;0;51;4;21;2;30;2
19;2020-S13;A;0;0;0;0;0;0
19;2020-S13;B;15;0;4;0;11;0
19;2020-S13;C;23;2;11;1;12;1
19;2020-S13;D;4;1;1;0;3;1
19;2020-S13;E;8;1;4;1;4;0
19;2020-S14;0;28;3;6;1;22;2
19;2020-S14;A;0;0;0;0;0;0
19;2020-S14;B;11;0;3;0;8;0
19;2020-S14;C;6;0;0;0;6;0
19;2020-S14;D;3;0;1;0;2;0
19;2020-S14;E;8;3;2;1;6;2
19;2020-S15;0;30;6;11;3;19;3
19;2020-S15;A;0;0;0;0;0;0
19;2020-S15;B;11;0;3;0;8;0
19;2020-S15;C;11;4;5;2;6;2
19;2020-S15;D;2;0;1;0;1;0
19;2020-S15;E;6;2;2;1;4;1
19;2020-S16;0;55;1;8;0;46;0
19;2020-S16;A;0;0;0;0;0;0
19;2020-S16;B;7;1;2;0;4;0
19;2020-S16;C;1;0;0;0;1;0
19;2020-S16;D;2;0;0;0;2;0
19;2020-S16;E;45;0;6;0;39;0
19;2020-S17;0;14;1;6;0;8;1
19;2020-S17;A;0;0;0;0;0;0
19;2020-S17;B;9;1;4;0;5;1
19;2020-S17;C;4;0;1;0;3;0
19;2020-S17;D;1;0;1;0;0;0
19;2020-S17;E;0;0;0;0;0;0
19;2020-S18;0;12;1;6;1;6;0
19;2020-S18;A;1;0;0;0;1;0
19;2020-S18;B;3;0;1;0;2;0
19;2020-S18;C;3;1;2;1;1;0
19;2020-S18;D;2;0;2;0;0;0
19;2020-S18;E;2;0;1;0;1;0
19;2020-S19;0;16;1;5;0;11;1
19;2020-S19;A;0;0;0;0;0;0
19;2020-S19;B;6;1;3;0;3;1
19;2020-S19;C;7;0;1;0;6;0
19;2020-S19;D;2;0;1;0;1;0
19;2020-S19;E;1;0;0;0;1;0
19;2020-S20;0;53;0;18;0;35;0
19;2020-S20;A;5;0;1;0;4;0
19;2020-S20;B;14;0;4;0;10;0
19;2020-S20;C;19;0;5;0;14;0
19;2020-S20;D;10;0;5;0;5;0
19;2020-S20;E;5;0;3;0;2;0
19;2020-S21;0;40;0;15;0;25;0
19;2020-S21;A;2;0;1;0;1;0
19;2020-S21;B;18;0;7;0;11;0
19;2020-S21;C;11;0;3;0;8;0
19;2020-S21;D;6;0;3;0;3;0
19;2020-S21;E;3;0;1;0;2;0
21;2020-S11;0;1;0;0;0;1;0
21;2020-S11;A;0;0;0;0;0;0
21;2020-S11;B;1;0;0;0;1;0
21;2020-S11;C;0;0;0;0;0;0
21;2020-S11;D;0;0;0;0;0;0
21;2020-S11;E;0;0;0;0;0;0
21;2020-S12;0;34;6;14;2;20;4
21;2020-S12;A;2;0;1;0;1;0
21;2020-S12;B;20;4;7;0;13;4
21;2020-S12;C;5;1;2;1;3;0
21;2020-S12;D;1;0;1;0;0;0
21;2020-S12;E;6;1;3;1;3;0
21;2020-S13;0;84;21;20;4;64;17
21;2020-S13;A;4;0;3;0;1;0
21;2020-S13;B;41;9;5;1;36;8
21;2020-S13;C;23;8;7;3;16;5
21;2020-S13;D;5;3;1;0;4;3
21;2020-S13;E;11;1;4;0;7;1
21;2020-S14;0;157;31;47;10;110;21
21;2020-S14;A;7;1;3;0;4;1
21;2020-S14;B;66;13;16;1;50;12
21;2020-S14;C;60;12;20;6;40;6
21;2020-S14;D;11;3;4;2;7;1
21;2020-S14;E;13;2;4;1;9;1
21;2020-S15;0;104;16;29;4;75;12
21;2020-S15;A;0;0;0;0;0;0
21;2020-S15;B;42;4;10;1;32;3
21;2020-S15;C;46;9;13;1;33;8
21;2020-S15;D;8;0;1;0;7;0
21;2020-S15;E;8;3;5;2;3;1
21;2020-S16;0;264;8;57;1;207;7
21;2020-S16;A;3;0;1;0;2;0
21;2020-S16;B;57;4;7;0;50;4
21;2020-S16;C;33;3;8;1;25;2
21;2020-S16;D;15;1;4;0;11;1
21;2020-S16;E;155;0;37;0;118;0
21;2020-S17;0;239;11;52;5;187;6
21;2020-S17;A;1;0;0;0;1;0
21;2020-S17;B;90;4;17;2;73;2
21;2020-S17;C;64;2;11;0;53;2
21;2020-S17;D;9;1;6;1;3;0
21;2020-S17;E;75;4;18;2;57;2
21;2020-S18;0;128;2;20;1;108;1
21;2020-S18;A;0;0;0;0;0;0
21;2020-S18;B;49;0;8;0;41;0
21;2020-S18;C;41;2;7;1;34;1
21;2020-S18;D;3;0;0;0;3;0
21;2020-S18;E;34;0;5;0;29;0
21;2020-S19;0;135;3;41;0;94;3
21;2020-S19;A;0;0;0;0;0;0
21;2020-S19;B;89;1;25;0;64;1
21;2020-S19;C;31;1;12;0;19;1
21;2020-S19;D;5;0;2;0;3;0
21;2020-S19;E;10;1;2;0;8;1
21;2020-S20;0;52;0;21;0;31;0
21;2020-S20;A;2;0;0;0;2;0
21;2020-S20;B;24;0;12;0;12;0
21;2020-S20;C;15;0;8;0;7;0
21;2020-S20;D;4;0;1;0;3;0
21;2020-S20;E;7;0;0;0;7;0
21;2020-S21;0;17;0;6;0;11;0
21;2020-S21;A;2;0;1;0;1;0
21;2020-S21;B;7;0;4;0;3;0
21;2020-S21;C;6;0;1;0;5;0
21;2020-S21;D;1;0;0;0;1;0
21;2020-S21;E;1;0;0;0;1;0
22;2020-S11;0;0;0;0;0;0;0
22;2020-S11;A;0;0;0;0;0;0
22;2020-S11;B;0;0;0;0;0;0
22;2020-S11;C;0;0;0;0;0;0
22;2020-S11;D;0;0;0;0;0;0
22;2020-S11;E;0;0;0;0;0;0
22;2020-S12;0;2;0;1;0;1;0
22;2020-S12;A;0;0;0;0;0;0
22;2020-S12;B;1;0;0;0;1;0
22;2020-S12;C;0;0;0;0;0;0
22;2020-S12;D;0;0;0;0;0;0
22;2020-S12;E;1;0;1;0;0;0
22;2020-S13;0;6;0;4;0;2;0
22;2020-S13;A;0;0;0;0;0;0
22;2020-S13;B;3;0;1;0;2;0
22;2020-S13;C;2;0;2;0;0;0
22;2020-S13;D;1;0;1;0;0;0
22;2020-S13;E;0;0;0;0;0;0
22;2020-S14;0;15;0;4;0;11;0
22;2020-S14;A;0;0;0;0;0;0
22;2020-S14;B;4;0;1;0;3;0
22;2020-S14;C;6;0;0;0;6;0
22;2020-S14;D;4;0;2;0;2;0
22;2020-S14;E;1;0;1;0;0;0
22;2020-S15;0;12;0;5;0;7;0
22;2020-S15;A;0;0;0;0;0;0
22;2020-S15;B;4;0;0;0;4;0
22;2020-S15;C;3;0;2;0;1;0
22;2020-S15;D;1;0;0;0;1;0
22;2020-S15;E;4;0;3;0;1;0
22;2020-S16;0;9;0;5;0;4;0
22;2020-S16;A;0;0;0;0;0;0
22;2020-S16;B;5;0;4;0;1;0
22;2020-S16;C;3;0;1;0;2;0
22;2020-S16;D;0;0;0;0;0;0
22;2020-S16;E;1;0;0;0;1;0
22;2020-S17;0;11;1;4;0;7;1
22;2020-S17;A;0;0;0;0;0;0
22;2020-S17;B;5;0;3;0;2;0
22;2020-S17;C;2;0;0;0;2;0
22;2020-S17;D;2;1;1;0;1;1
22;2020-S17;E;2;0;0;0;2;0
22;2020-S18;0;23;0;9;0;14;0
22;2020-S18;A;0;0;0;0;0;0
22;2020-S18;B;9;0;5;0;4;0
22;2020-S18;C;7;0;2;0;5;0
22;2020-S18;D;6;0;1;0;5;0
22;2020-S18;E;1;0;1;0;0;0
22;2020-S19;0;10;0;6;0;4;0
22;2020-S19;A;1;0;1;0;0;0
22;2020-S19;B;3;0;1;0;2;0
22;2020-S19;C;4;0;3;0;1;0
22;2020-S19;D;2;0;1;0;1;0
22;2020-S19;E;0;0;0;0;0;0
22;2020-S20;0;4;0;3;0;1;0
22;2020-S20;A;0;0;0;0;0;0
22;2020-S20;B;2;0;2;0;0;0
22;2020-S20;C;2;0;1;0;1;0
22;2020-S20;D;0;0;0;0;0;0
22;2020-S20;E;0;0;0;0;0;0
22;2020-S21;0;83;2;35;1;48;1
22;2020-S21;A;5;0;1;0;4;0
22;2020-S21;B;38;1;16;0;22;1
22;2020-S21;C;24;1;11;1;13;0
22;2020-S21;D;11;0;5;0;6;0
22;2020-S21;E;5;0;2;0;3;0
23;2020-S11;0;0;0;0;0;0;0
23;2020-S11;A;0;0;0;0;0;0
23;2020-S11;B;0;0;0;0;0;0
23;2020-S11;C;0;0;0;0;0;0
23;2020-S11;D;0;0;0;0;0;0
23;2020-S11;E;0;0;0;0;0;0
23;2020-S12;0;0;0;0;0;0;0
23;2020-S12;A;0;0;0;0;0;0
23;2020-S12;B;0;0;0;0;0;0
23;2020-S12;C;0;0;0;0;0;0
23;2020-S12;D;0;0;0;0;0;0
23;2020-S12;E;0;0;0;0;0;0
23;2020-S13;0;6;0;4;0;2;0
23;2020-S13;A;0;0;0;0;0;0
23;2020-S13;B;3;0;3;0;0;0
23;2020-S13;C;2;0;1;0;1;0
23;2020-S13;D;0;0;0;0;0;0
23;2020-S13;E;1;0;0;0;1;0
23;2020-S14;0;27;2;4;0;22;2
23;2020-S14;A;0;0;0;0;0;0
23;2020-S14;B;13;2;1;0;11;2
23;2020-S14;C;10;0;1;0;9;0
23;2020-S14;D;3;0;1;0;2;0
23;2020-S14;E;1;0;1;0;0;0
23;2020-S15;0;26;3;9;1;17;2
23;2020-S15;A;0;0;0;0;0;0
23;2020-S15;B;11;0;5;0;6;0
23;2020-S15;C;12;2;3;0;9;2
23;2020-S15;D;0;0;0;0;0;0
23;2020-S15;E;3;1;1;1;2;0
23;2020-S16;0;76;1;16;0;57;1
23;2020-S16;A;3;0;3;0;0;0
23;2020-S16;B;31;0;5;0;24;0
23;2020-S16;C;31;1;5;0;25;1
23;2020-S16;D;8;0;3;0;5;0
23;2020-S16;E;3;0;0;0;3;0
23;2020-S17;0;29;0;15;0;14;0
23;2020-S17;A;0;0;0;0;0;0
23;2020-S17;B;8;0;4;0;4;0
23;2020-S17;C;8;0;7;0;1;0
23;2020-S17;D;4;0;2;0;2;0
23;2020-S17;E;9;0;2;0;7;0
23;2020-S18;0;34;2;9;1;25;1
23;2020-S18;A;0;0;0;0;0;0
23;2020-S18;B;13;1;4;0;9;1
23;2020-S18;C;13;0;3;0;10;0
23;2020-S18;D;4;0;1;0;3;0
23;2020-S18;E;4;1;1;1;3;0
23;2020-S19;0;95;1;33;0;60;1
23;2020-S19;A;1;0;0;0;1;0
23;2020-S19;B;30;0;7;0;21;0
23;2020-S19;C;42;0;12;0;30;0
23;2020-S19;D;7;0;6;0;1;0
23;2020-S19;E;10;1;6;0;4;1
23;2020-S20;0;432;1;126;0;302;1
23;2020-S20;A;5;0;3;0;2;0
23;2020-S20;B;131;0;31;0;97;0
23;2020-S20;C;133;1;39;0;93;1
23;2020-S20;D;34;0;21;0;13;0
23;2020-S20;E;129;0;32;0;97;0
23;2020-S21;0;382;1;117;1;261;0
23;2020-S21;A;8;0;5;0;3;0
23;2020-S21;B;115;1;25;1;86;0
23;2020-S21;C;131;0;33;0;98;0
23;2020-S21;D;47;0;27;0;20;0
23;2020-S21;E;80;0;26;0;54;0
24;2020-S11;0;3;0;1;0;2;0
24;2020-S11;A;0;0;0;0;0;0
24;2020-S11;B;1;0;0;0;1;0
24;2020-S11;C;2;0;1;0;1;0
24;2020-S11;D;0;0;0;0;0;0
24;2020-S11;E;0;0;0;0;0;0
24;2020-S12;0;15;2;5;0;10;2
24;2020-S12;A;0;0;0;0;0;0
24;2020-S12;B;3;0;0;0;3;0
24;2020-S12;C;8;1;2;0;6;1
24;2020-S12;D;3;1;2;0;1;1
24;2020-S12;E;1;0;1;0;0;0
24;2020-S13;0;112;12;34;5;78;7
24;2020-S13;A;1;0;0;0;1;0
24;2020-S13;B;47;3;9;1;38;2
24;2020-S13;C;36;6;12;3;24;3
24;2020-S13;D;12;1;8;0;4;1
24;2020-S13;E;14;1;5;1;9;0
24;2020-S14;0;143;8;45;3;98;5
24;2020-S14;A;1;0;1;0;0;0
24;2020-S14;B;54;2;10;0;44;2
24;2020-S14;C;59;5;20;2;39;3
24;2020-S14;D;14;1;8;1;6;0
24;2020-S14;E;15;0;6;0;9;0
24;2020-S15;0;136;3;34;2;102;1
24;2020-S15;A;1;0;0;0;1;0
24;2020-S15;B;51;0;7;0;44;0
24;2020-S15;C;48;2;17;2;31;0
24;2020-S15;D;15;1;7;0;8;1
24;2020-S15;E;7;0;2;0;5;0
24;2020-S16;0;85;0;21;0;64;0
24;2020-S16;A;0;0;0;0;0;0
24;2020-S16;B;26;0;9;0;17;0
24;2020-S16;C;25;0;5;0;20;0
24;2020-S16;D;5;0;3;0;2;0
24;2020-S16;E;29;0;4;0;25;0
24;2020-S17;0;31;1;11;0;20;1
24;2020-S17;A;2;0;1;0;1;0
24;2020-S17;B;12;0;4;0;8;0
24;2020-S17;C;9;1;3;0;6;1
24;2020-S17;D;2;0;1;0;1;0
24;2020-S17;E;6;0;2;0;4;0
24;2020-S18;0;4;0;1;0;3;0
24;2020-S18;A;1;0;0;0;1;0
24;2020-S18;B;1;0;0;0;1;0
24;2020-S18;C;0;0;0;0;0;0
24;2020-S18;D;1;0;1;0;0;0
24;2020-S18;E;1;0;0;0;1;0
24;2020-S19;0;2;0;1;0;1;0
24;2020-S19;A;0;0;0;0;0;0
24;2020-S19;B;0;0;0;0;0;0
24;2020-S19;C;0;0;0;0;0;0
24;2020-S19;D;0;0;0;0;0;0
24;2020-S19;E;2;0;1;0;1;0
24;2020-S20;0;35;0;18;0;17;0
24;2020-S20;A;0;0;0;0;0;0
24;2020-S20;B;13;0;6;0;7;0
24;2020-S20;C;9;0;5;0;4;0
24;2020-S20;D;9;0;5;0;4;0
24;2020-S20;E;4;0;2;0;2;0
24;2020-S21;0;13;0;6;0;6;0
24;2020-S21;A;1;0;1;0;0;0
24;2020-S21;B;7;0;2;0;4;0
24;2020-S21;C;3;0;1;0;2;0
24;2020-S21;D;2;0;2;0;0;0
24;2020-S21;E;0;0;0;0;0;0
25;2020-S11;0;1;1;1;1;0;0
25;2020-S11;A;0;0;0;0;0;0
25;2020-S11;B;1;1;1;1;0;0
25;2020-S11;C;0;0;0;0;0;0
25;2020-S11;D;0;0;0;0;0;0
25;2020-S11;E;0;0;0;0;0;0
25;2020-S12;0;8;1;4;1;4;0
25;2020-S12;A;0;0;0;0;0;0
25;2020-S12;B;5;1;2;1;3;0
25;2020-S12;C;1;0;1;0;0;0
25;2020-S12;D;1;0;1;0;0;0
25;2020-S12;E;1;0;0;0;1;0
25;2020-S13;0;135;47;36;15;99;32
25;2020-S13;A;0;0;0;0;0;0
25;2020-S13;B;60;21;10;3;50;18
25;2020-S13;C;51;20;17;9;34;11
25;2020-S13;D;9;3;6;3;3;0
25;2020-S13;E;15;3;3;0;12;3
25;2020-S14;0;186;41;54;10;132;31
25;2020-S14;A;0;0;0;0;0;0
25;2020-S14;B;85;17;18;3;67;14
25;2020-S14;C;68;11;20;1;48;10
25;2020-S14;D;17;6;9;2;8;4
25;2020-S14;E;16;7;7;4;9;3
25;2020-S15;0;203;54;51;13;152;41
25;2020-S15;A;1;0;0;0;1;0
25;2020-S15;B;79;20;16;3;63;17
25;2020-S15;C;80;20;20;6;60;14
25;2020-S15;D;18;5;10;2;8;3
25;2020-S15;E;25;9;5;2;20;7
25;2020-S16;0;191;38;51;10;140;28
25;2020-S16;A;3;0;1;0;2;0
25;2020-S16;B;80;7;11;0;69;7
25;2020-S16;C;55;15;21;5;34;10
25;2020-S16;D;6;2;2;0;4;2
25;2020-S16;E;47;14;16;5;31;9
25;2020-S17;0;437;13;96;2;341;11
25;2020-S17;A;1;0;0;0;1;0
25;2020-S17;B;153;7;25;0;128;7
25;2020-S17;C;133;5;26;1;107;4
25;2020-S17;D;22;0;10;0;12;0
25;2020-S17;E;127;1;35;1;92;0
25;2020-S18;0;127;12;40;6;87;6
25;2020-S18;A;5;0;2;0;3;0
25;2020-S18;B;51;8;16;4;35;4
25;2020-S18;C;31;1;10;0;21;1
25;2020-S18;D;12;0;4;0;8;0
25;2020-S18;E;28;3;8;2;20;1
25;2020-S19;0;294;3;73;0;221;3
25;2020-S19;A;6;0;4;0;2;0
25;2020-S19;B;112;1;22;0;90;1
25;2020-S19;C;106;2;26;0;80;2
25;2020-S19;D;9;0;5;0;4;0
25;2020-S19;E;61;0;16;0;45;0
25;2020-S20;0;360;3;140;3;220;0
25;2020-S20;A;22;0;11;0;11;0
25;2020-S20;B;170;0;73;0;97;0
25;2020-S20;C;97;2;32;2;65;0
25;2020-S20;D;37;0;11;0;26;0
25;2020-S20;E;33;1;13;1;20;0
25;2020-S21;0;132;0;58;0;74;0
25;2020-S21;A;9;0;4;0;5;0
25;2020-S21;B;59;0;28;0;31;0
25;2020-S21;C;34;0;13;0;21;0
25;2020-S21;D;11;0;4;0;7;0
25;2020-S21;E;18;0;8;0;10;0
26;2020-S11;0;3;1;1;0;2;1
26;2020-S11;A;0;0;0;0;0;0
26;2020-S11;B;1;0;1;0;0;0
26;2020-S11;C;0;0;0;0;0;0
26;2020-S11;D;1;0;0;0;1;0
26;2020-S11;E;1;1;0;0;1;1
26;2020-S12;0;70;19;27;9;43;10
26;2020-S12;A;0;0;0;0;0;0
26;2020-S12;B;22;2;6;1;16;1
26;2020-S12;C;19;4;6;2;13;2
26;2020-S12;D;14;7;9;4;5;3
26;2020-S12;E;15;6;6;2;9;4
26;2020-S13;0;172;42;63;20;109;22
26;2020-S13;A;0;0;0;0;0;0
26;2020-S13;B;67;12;20;5;47;7
26;2020-S13;C;57;15;17;6;40;9
26;2020-S13;D;21;5;13;4;8;1
26;2020-S13;E;27;10;13;5;14;5
26;2020-S14;0;203;24;79;12;124;12
26;2020-S14;A;4;0;1;0;3;0
26;2020-S14;B;68;3;20;1;48;2
26;2020-S14;C;77;8;35;3;42;5
26;2020-S14;D;23;6;8;4;15;2
26;2020-S14;E;31;7;15;4;16;3
26;2020-S15;0;154;19;54;4;100;15
26;2020-S15;A;0;0;0;0;0;0
26;2020-S15;B;43;5;11;0;32;5
26;2020-S15;C;59;5;25;3;34;2
26;2020-S15;D;25;1;12;0;13;1
26;2020-S15;E;26;8;6;1;20;7
26;2020-S16;0;190;15;64;5;125;10
26;2020-S16;A;0;0;0;0;0;0
26;2020-S16;B;77;2;23;1;54;1
26;2020-S16;C;53;2;14;1;39;1
26;2020-S16;D;19;0;9;0;10;0
26;2020-S16;E;41;11;18;3;22;8
26;2020-S17;0;250;7;71;1;178;6
26;2020-S17;A;1;0;0;0;1;0
26;2020-S17;B;77;2;20;0;56;2
26;2020-S17;C;57;3;14;0;43;3
26;2020-S17;D;20;1;6;1;14;0
26;2020-S17;E;95;1;31;0;64;1
26;2020-S18;0;195;3;52;1;143;2
26;2020-S18;A;1;0;0;0;1;0
26;2020-S18;B;69;1;15;0;54;1
26;2020-S18;C;75;2;17;1;58;1
26;2020-S18;D;18;0;9;0;9;0
26;2020-S18;E;29;0;8;0;21;0
26;2020-S19;0;234;5;96;2;138;3
26;2020-S19;A;4;0;3;0;1;0
26;2020-S19;B;78;0;31;0;47;0
26;2020-S19;C;72;2;25;0;47;2
26;2020-S19;D;25;2;16;2;9;0
26;2020-S19;E;55;1;21;0;34;1
26;2020-S20;0;205;0;90;0;115;0
26;2020-S20;A;16;0;5;0;11;0
26;2020-S20;B;84;0;37;0;47;0
26;2020-S20;C;64;0;28;0;36;0
26;2020-S20;D;22;0;14;0;8;0
26;2020-S20;E;19;0;6;0;13;0
26;2020-S21;0;176;0;100;0;76;0
26;2020-S21;A;18;0;13;0;5;0
26;2020-S21;B;70;0;42;0;28;0
26;2020-S21;C;53;0;28;0;25;0
26;2020-S21;D;18;0;10;0;8;0
26;2020-S21;E;17;0;7;0;10;0
27;2020-S11;0;1;0;1;0;0;0
27;2020-S11;A;0;0;0;0;0;0
27;2020-S11;B;1;0;1;0;0;0
27;2020-S11;C;0;0;0;0;0;0
27;2020-S11;D;0;0;0;0;0;0
27;2020-S11;E;0;0;0;0;0;0
27;2020-S12;0;41;6;11;3;30;3
27;2020-S12;A;0;0;0;0;0;0
27;2020-S12;B;23;3;4;1;19;2
27;2020-S12;C;10;2;4;1;6;1
27;2020-S12;D;2;1;1;1;1;0
27;2020-S12;E;6;0;2;0;4;0
27;2020-S13;0;269;48;75;19;194;29
27;2020-S13;A;1;0;1;0;0;0
27;2020-S13;B;94;5;15;2;79;3
27;2020-S13;C;90;20;25;7;65;13
27;2020-S13;D;25;7;17;5;8;2
27;2020-S13;E;40;15;11;4;29;11
27;2020-S14;0;354;79;101;21;253;58
27;2020-S14;A;3;0;3;0;0;0
27;2020-S14;B;168;33;33;7;135;26
27;2020-S14;C;121;27;32;3;89;24
27;2020-S14;D;28;7;16;5;12;2
27;2020-S14;E;30;10;16;5;14;5
27;2020-S15;0;793;175;231;44;562;131
27;2020-S15;A;4;2;1;1;3;1
27;2020-S15;B;195;31;42;4;153;27
27;2020-S15;C;180;41;56;9;124;32
27;2020-S15;D;72;11;41;5;31;6
27;2020-S15;E;333;90;91;25;242;65
27;2020-S16;0;918;125;262;37;656;88
27;2020-S16;A;6;0;5;0;1;0
27;2020-S16;B;414;22;95;5;319;17
27;2020-S16;C;263;32;84;13;179;19
27;2020-S16;D;64;15;34;8;30;7
27;2020-S16;E;170;56;44;11;126;45
27;2020-S17;0;728;62;195;11;533;51
27;2020-S17;A;2;0;1;0;1;0
27;2020-S17;B;295;12;77;0;218;12
27;2020-S17;C;238;15;60;5;178;10
27;2020-S17;D;49;4;27;2;22;2
27;2020-S17;E;142;31;28;4;114;27
27;2020-S18;0;623;33;192;8;431;25
27;2020-S18;A;3;1;2;1;1;0
27;2020-S18;B;197;11;54;3;143;8
27;2020-S18;C;154;7;58;3;96;4
27;2020-S18;D;42;1;20;0;22;1
27;2020-S18;E;224;13;57;1;167;12
27;2020-S19;0;551;16;185;5;366;11
27;2020-S19;A;13;0;6;0;7;0
27;2020-S19;B;227;6;65;1;162;5
27;2020-S19;C;180;7;62;3;118;4
27;2020-S19;D;40;0;21;0;19;0
27;2020-S19;E;90;3;31;1;59;2
27;2020-S20;0;819;16;344;2;475;14
27;2020-S20;A;35;0;20;0;15;0
27;2020-S20;B;279;3;120;0;159;3
27;2020-S20;C;234;3;113;0;121;3
27;2020-S20;D;75;2;35;0;40;2
27;2020-S20;E;195;8;56;2;139;6
27;2020-S21;0;491;15;213;3;278;12
27;2020-S21;A;37;0;20;0;17;0
27;2020-S21;B;166;4;79;1;87;3
27;2020-S21;C;160;4;64;2;96;2
27;2020-S21;D;54;0;29;0;25;0
27;2020-S21;E;74;7;21;0;53;7
28;2020-S11;0;8;3;4;1;4;2
28;2020-S11;A;0;0;0;0;0;0
28;2020-S11;B;0;0;0;0;0;0
28;2020-S11;C;3;1;2;0;1;1
28;2020-S11;D;1;1;0;0;1;1
28;2020-S11;E;4;1;2;1;2;0
28;2020-S12;0;32;7;12;4;20;3
28;2020-S12;A;0;0;0;0;0;0
28;2020-S12;B;5;1;1;0;4;1
28;2020-S12;C;11;2;5;2;6;0
28;2020-S12;D;2;0;2;0;0;0
28;2020-S12;E;14;4;4;2;10;2
28;2020-S13;0;280;98;90;43;190;55
28;2020-S13;A;2;0;1;0;1;0
28;2020-S13;B;92;22;19;4;73;18
28;2020-S13;C;106;33;32;17;74;16
28;2020-S13;D;43;25;24;14;19;11
28;2020-S13;E;37;18;14;8;23;10
28;2020-S14;0;415;134;130;42;285;92
28;2020-S14;A;6;3;3;3;3;0
28;2020-S14;B;180;49;54;11;126;38
28;2020-S14;C;129;42;34;10;95;32
28;2020-S14;D;26;8;12;3;14;5
28;2020-S14;E;74;32;27;15;47;17
28;2020-S15;0;761;272;202;84;559;188
28;2020-S15;A;8;0;2;0;6;0
28;2020-S15;B;211;54;57;18;154;36
28;2020-S15;C;197;59;53;21;144;38
28;2020-S15;D;44;20;21;12;23;8
28;2020-S15;E;301;139;69;33;232;106
28;2020-S16;0;346;54;74;13;272;41
28;2020-S16;A;0;0;0;0;0;0
28;2020-S16;B;107;9;15;1;92;8
28;2020-S16;C;80;7;14;2;66;5
28;2020-S16;D;20;2;11;1;9;1
28;2020-S16;E;139;36;34;9;105;27
28;2020-S17;0;657;28;124;7;533;21
28;2020-S17;A;1;0;0;0;1;0
28;2020-S17;B;226;2;35;0;191;2
28;2020-S17;C;198;9;37;2;161;7
28;2020-S17;D;23;1;9;0;14;1
28;2020-S17;E;209;16;43;5;166;11
28;2020-S18;0;453;15;104;2;349;13
28;2020-S18;A;0;0;0;0;0;0
28;2020-S18;B;191;7;31;1;160;6
28;2020-S18;C;169;4;48;0;121;4
28;2020-S18;D;6;0;3;0;3;0
28;2020-S18;E;87;4;22;1;65;3
28;2020-S19;0;587;17;99;4;488;13
28;2020-S19;A;1;0;0;0;1;0
28;2020-S19;B;180;2;18;0;162;2
28;2020-S19;C;191;1;33;1;158;0
28;2020-S19;D;17;1;7;1;10;0
28;2020-S19;E;197;13;40;2;157;11
28;2020-S20;0;459;22;141;4;318;18
28;2020-S20;A;11;0;4;0;7;0
28;2020-S20;B;166;2;51;0;115;2
28;2020-S20;C;138;1;42;0;96;1
28;2020-S20;D;23;0;12;0;11;0
28;2020-S20;E;121;19;32;4;89;15
28;2020-S21;0;254;1;79;0;175;1
28;2020-S21;A;8;1;3;0;5;1
28;2020-S21;B;72;0;21;0;51;0
28;2020-S21;C;70;0;26;0;44;0
28;2020-S21;D;16;0;12;0;4;0
28;2020-S21;E;88;0;17;0;71;0
29;2020-S11;0;2;1;1;0;1;1
29;2020-S11;A;0;0;0;0;0;0
29;2020-S11;B;1;1;0;0;1;1
29;2020-S11;C;0;0;0;0;0;0
29;2020-S11;D;1;0;1;0;0;0
29;2020-S11;E;0;0;0;0;0;0
29;2020-S12;0;5;2;2;1;3;1
29;2020-S12;A;0;0;0;0;0;0
29;2020-S12;B;3;2;1;1;2;1
29;2020-S12;C;2;0;1;0;1;0
29;2020-S12;D;0;0;0;0;0;0
29;2020-S12;E;0;0;0;0;0;0
29;2020-S13;0;5;2;2;0;3;2
29;2020-S13;A;0;0;0;0;0;0
29;2020-S13;B;3;2;1;0;2;2
29;2020-S13;C;1;0;0;0;1;0
29;2020-S13;D;1;0;1;0;0;0
29;2020-S13;E;0;0;0;0;0;0
29;2020-S14;0;4;1;2;0;2;1
29;2020-S14;A;0;0;0;0;0;0
29;2020-S14;B;3;1;1;0;2;1
29;2020-S14;C;0;0;0;0;0;0
29;2020-S14;D;1;0;1;0;0;0
29;2020-S14;E;0;0;0;0;0;0
29;2020-S15;0;4;1;0;0;4;1
29;2020-S15;A;0;0;0;0;0;0
29;2020-S15;B;2;1;0;0;2;1
29;2020-S15;C;1;0;0;0;1;0
29;2020-S15;D;0;0;0;0;0;0
29;2020-S15;E;1;0;0;0;1;0
29;2020-S16;0;3;0;1;0;2;0
29;2020-S16;A;0;0;0;0;0;0
29;2020-S16;B;0;0;0;0;0;0
29;2020-S16;C;1;0;0;0;1;0
29;2020-S16;D;0;0;0;0;0;0
29;2020-S16;E;2;0;1;0;1;0
29;2020-S17;0;8;2;5;2;3;0
29;2020-S17;A;0;0;0;0;0;0
29;2020-S17;B;5;2;3;2;2;0
29;2020-S17;C;1;0;1;0;0;0
29;2020-S17;D;2;0;1;0;1;0
29;2020-S17;E;0;0;0;0;0;0
29;2020-S18;0;1;0;1;0;0;0
29;2020-S18;A;0;0;0;0;0;0
29;2020-S18;B;0;0;0;0;0;0
29;2020-S18;C;1;0;1;0;0;0
29;2020-S18;D;0;0;0;0;0;0
29;2020-S18;E;0;0;0;0;0;0
29;2020-S19;0;2;0;1;0;1;0
29;2020-S19;A;0;0;0;0;0;0
29;2020-S19;B;1;0;1;0;0;0
29;2020-S19;C;1;0;0;0;1;0
29;2020-S19;D;0;0;0;0;0;0
29;2020-S19;E;0;0;0;0;0;0
29;2020-S20;0;2;0;0;0;2;0
29;2020-S20;A;0;0;0;0;0;0
29;2020-S20;B;1;0;0;0;1;0
29;2020-S20;C;0;0;0;0;0;0
29;2020-S20;D;0;0;0;0;0;0
29;2020-S20;E;1;0;0;0;1;0
29;2020-S21;0;7;0;7;0;0;0
29;2020-S21;A;0;0;0;0;0;0
29;2020-S21;B;6;0;6;0;0;0
29;2020-S21;C;1;0;1;0;0;0
29;2020-S21;D;0;0;0;0;0;0
29;2020-S21;E;0;0;0;0;0;0
2A;2020-S11;0;0;0;0;0;0;0
2A;2020-S11;A;0;0;0;0;0;0
2A;2020-S11;B;0;0;0;0;0;0
2A;2020-S11;C;0;0;0;0;0;0
2A;2020-S11;D;0;0;0;0;0;0
2A;2020-S11;E;0;0;0;0;0;0
2A;2020-S12;0;0;0;0;0;0;0
2A;2020-S12;A;0;0;0;0;0;0
2A;2020-S12;B;0;0;0;0;0;0
2A;2020-S12;C;0;0;0;0;0;0
2A;2020-S12;D;0;0;0;0;0;0
2A;2020-S12;E;0;0;0;0;0;0
2A;2020-S13;0;0;0;0;0;0;0
2A;2020-S13;A;0;0;0;0;0;0
2A;2020-S13;B;0;0;0;0;0;0
2A;2020-S13;C;0;0;0;0;0;0
2A;2020-S13;D;0;0;0;0;0;0
2A;2020-S13;E;0;0;0;0;0;0
2A;2020-S14;0;0;0;0;0;0;0
2A;2020-S14;A;0;0;0;0;0;0
2A;2020-S14;B;0;0;0;0;0;0
2A;2020-S14;C;0;0;0;0;0;0
2A;2020-S14;D;0;0;0;0;0;0
2A;2020-S14;E;0;0;0;0;0;0
2A;2020-S15;0;0;0;0;0;0;0
2A;2020-S15;A;0;0;0;0;0;0
2A;2020-S15;B;0;0;0;0;0;0
2A;2020-S15;C;0;0;0;0;0;0
2A;2020-S15;D;0;0;0;0;0;0
2A;2020-S15;E;0;0;0;0;0;0
2A;2020-S16;0;0;0;0;0;0;0
2A;2020-S16;A;0;0;0;0;0;0
2A;2020-S16;B;0;0;0;0;0;0
2A;2020-S16;C;0;0;0;0;0;0
2A;2020-S16;D;0;0;0;0;0;0
2A;2020-S16;E;0;0;0;0;0;0
2A;2020-S17;0;0;0;0;0;0;0
2A;2020-S17;A;0;0;0;0;0;0
2A;2020-S17;B;0;0;0;0;0;0
2A;2020-S17;C;0;0;0;0;0;0
2A;2020-S17;D;0;0;0;0;0;0
2A;2020-S17;E;0;0;0;0;0;0
2A;2020-S18;0;0;0;0;0;0;0
2A;2020-S18;A;0;0;0;0;0;0
2A;2020-S18;B;0;0;0;0;0;0
2A;2020-S18;C;0;0;0;0;0;0
2A;2020-S18;D;0;0;0;0;0;0
2A;2020-S18;E;0;0;0;0;0;0
2A;2020-S19;0;0;0;0;0;0;0
2A;2020-S19;A;0;0;0;0;0;0
2A;2020-S19;B;0;0;0;0;0;0
2A;2020-S19;C;0;0;0;0;0;0
2A;2020-S19;D;0;0;0;0;0;0
2A;2020-S19;E;0;0;0;0;0;0
2A;2020-S20;0;0;0;0;0;0;0
2A;2020-S20;A;0;0;0;0;0;0
2A;2020-S20;B;0;0;0;0;0;0
2A;2020-S20;C;0;0;0;0;0;0
2A;2020-S20;D;0;0;0;0;0;0
2A;2020-S20;E;0;0;0;0;0;0
2A;2020-S21;0;0;0;0;0;0;0
2A;2020-S21;A;0;0;0;0;0;0
2A;2020-S21;B;0;0;0;0;0;0
2A;2020-S21;C;0;0;0;0;0;0
2A;2020-S21;D;0;0;0;0;0;0
2A;2020-S21;E;0;0;0;0;0;0
2B;2020-S11;0;0;0;0;0;0;0
2B;2020-S11;A;0;0;0;0;0;0
2B;2020-S11;B;0;0;0;0;0;0
2B;2020-S11;C;0;0;0;0;0;0
2B;2020-S11;D;0;0;0;0;0;0
2B;2020-S11;E;0;0;0;0;0;0
2B;2020-S12;0;0;0;0;0;0;0
2B;2020-S12;A;0;0;0;0;0;0
2B;2020-S12;B;0;0;0;0;0;0
2B;2020-S12;C;0;0;0;0;0;0
2B;2020-S12;D;0;0;0;0;0;0
2B;2020-S12;E;0;0;0;0;0;0
2B;2020-S13;0;0;0;0;0;0;0
2B;2020-S13;A;0;0;0;0;0;0
2B;2020-S13;B;0;0;0;0;0;0
2B;2020-S13;C;0;0;0;0;0;0
2B;2020-S13;D;0;0;0;0;0;0
2B;2020-S13;E;0;0;0;0;0;0
2B;2020-S14;0;0;0;0;0;0;0
2B;2020-S14;A;0;0;0;0;0;0
2B;2020-S14;B;0;0;0;0;0;0
2B;2020-S14;C;0;0;0;0;0;0
2B;2020-S14;D;0;0;0;0;0;0
2B;2020-S14;E;0;0;0;0;0;0
2B;2020-S15;0;0;0;0;0;0;0
2B;2020-S15;A;0;0;0;0;0;0
2B;2020-S15;B;0;0;0;0;0;0
2B;2020-S15;C;0;0;0;0;0;0
2B;2020-S15;D;0;0;0;0;0;0
2B;2020-S15;E;0;0;0;0;0;0
2B;2020-S16;0;0;0;0;0;0;0
2B;2020-S16;A;0;0;0;0;0;0
2B;2020-S16;B;0;0;0;0;0;0
2B;2020-S16;C;0;0;0;0;0;0
2B;2020-S16;D;0;0;0;0;0;0
2B;2020-S16;E;0;0;0;0;0;0
2B;2020-S17;0;0;0;0;0;0;0
2B;2020-S17;A;0;0;0;0;0;0
2B;2020-S17;B;0;0;0;0;0;0
2B;2020-S17;C;0;0;0;0;0;0
2B;2020-S17;D;0;0;0;0;0;0
2B;2020-S17;E;0;0;0;0;0;0
2B;2020-S18;0;0;0;0;0;0;0
2B;2020-S18;A;0;0;0;0;0;0
2B;2020-S18;B;0;0;0;0;0;0
2B;2020-S18;C;0;0;0;0;0;0
2B;2020-S18;D;0;0;0;0;0;0
2B;2020-S18;E;0;0;0;0;0;0
2B;2020-S19;0;0;0;0;0;0;0
2B;2020-S19;A;0;0;0;0;0;0
2B;2020-S19;B;0;0;0;0;0;0
2B;2020-S19;C;0;0;0;0;0;0
2B;2020-S19;D;0;0;0;0;0;0
2B;2020-S19;E;0;0;0;0;0;0
2B;2020-S20;0;0;0;0;0;0;0
2B;2020-S20;A;0;0;0;0;0;0
2B;2020-S20;B;0;0;0;0;0;0
2B;2020-S20;C;0;0;0;0;0;0
2B;2020-S20;D;0;0;0;0;0;0
2B;2020-S20;E;0;0;0;0;0;0
2B;2020-S21;0;0;0;0;0;0;0
2B;2020-S21;A;0;0;0;0;0;0
2B;2020-S21;B;0;0;0;0;0;0
2B;2020-S21;C;0;0;0;0;0;0
2B;2020-S21;D;0;0;0;0;0;0
2B;2020-S21;E;0;0;0;0;0;0
30;2020-S11;0;3;0;2;0;1;0
30;2020-S11;A;0;0;0;0;0;0
30;2020-S11;B;0;0;0;0;0;0
30;2020-S11;C;1;0;0;0;1;0
30;2020-S11;D;0;0;0;0;0;0
30;2020-S11;E;2;0;2;0;0;0
30;2020-S12;0;64;7;27;3;37;4
30;2020-S12;A;1;0;1;0;0;0
30;2020-S12;B;21;3;5;1;16;2
30;2020-S12;C;16;1;12;1;4;0
30;2020-S12;D;8;3;3;1;5;2
30;2020-S12;E;18;0;6;0;12;0
30;2020-S13;0;375;32;131;17;243;15
30;2020-S13;A;1;0;0;0;0;0
30;2020-S13;B;150;7;36;2;114;5
30;2020-S13;C;128;18;49;11;79;7
30;2020-S13;D;30;2;17;0;13;2
30;2020-S13;E;66;5;29;4;37;1
30;2020-S14;0;933;79;290;33;639;46
30;2020-S14;A;10;0;2;0;4;0
30;2020-S14;B;410;29;98;10;312;19
30;2020-S14;C;346;32;112;10;234;22
30;2020-S14;D;81;10;42;8;39;2
30;2020-S14;E;85;8;36;5;49;3
30;2020-S15;0;1229;61;355;14;868;47
30;2020-S15;A;13;1;3;1;5;0
30;2020-S15;B;472;16;107;3;365;13
30;2020-S15;C;403;14;116;2;287;12
30;2020-S15;D;90;6;48;3;42;3
30;2020-S15;E;250;23;81;5;168;18
30;2020-S16;0;953;31;330;12;622;19
30;2020-S16;A;13;2;7;1;5;1
30;2020-S16;B;377;12;110;3;267;9
30;2020-S16;C;339;10;124;5;215;5
30;2020-S16;D;86;1;48;1;38;0
30;2020-S16;E;137;6;40;2;97;4
30;2020-S17;0;1423;33;475;16;947;17
30;2020-S17;A;15;2;14;2;1;0
30;2020-S17;B;468;13;147;5;321;8
30;2020-S17;C;424;8;139;5;285;3
30;2020-S17;D;126;2;62;1;64;1
30;2020-S17;E;389;8;112;3;276;5
30;2020-S18;0;1033;18;409;7;623;11
30;2020-S18;A;15;1;8;1;6;0
30;2020-S18;B;380;9;148;4;232;5
30;2020-S18;C;289;3;118;1;171;2
30;2020-S18;D;101;1;58;1;43;0
30;2020-S18;E;247;4;76;0;171;4
30;2020-S19;0;1165;32;485;10;680;22
30;2020-S19;A;35;1;20;0;15;1
30;2020-S19;B;429;12;186;6;243;6
30;2020-S19;C;342;2;147;0;195;2
30;2020-S19;D;109;2;56;0;53;2
30;2020-S19;E;248;15;75;4;173;11
30;2020-S20;0;2005;12;824;6;1179;6
30;2020-S20;A;90;1;52;0;38;1
30;2020-S20;B;703;6;271;4;431;2
30;2020-S20;C;642;4;269;2;372;2
30;2020-S20;D;240;1;107;0;133;1
30;2020-S20;E;327;0;123;0;204;0
30;2020-S21;0;1840;13;841;6;994;7
30;2020-S21;A;84;2;45;1;36;1
30;2020-S21;B;601;5;283;4;317;1
30;2020-S21;C;603;4;274;1;328;3
30;2020-S21;D;211;1;108;0;103;1
30;2020-S21;E;338;1;131;0;207;1
31;2020-S11;0;8;0;2;0;6;0
31;2020-S11;A;0;0;0;0;0;0
31;2020-S11;B;4;0;0;0;4;0
31;2020-S11;C;3;0;1;0;2;0
31;2020-S11;D;1;0;1;0;0;0
31;2020-S11;E;0;0;0;0;0;0
31;2020-S12;0;243;31;69;11;174;20
31;2020-S12;A;5;0;5;0;0;0
31;2020-S12;B;113;16;25;6;88;10
31;2020-S12;C;79;11;22;3;57;8
31;2020-S12;D;7;1;7;1;0;0
31;2020-S12;E;38;3;10;1;28;2
31;2020-S13;0;508;70;168;32;340;38
31;2020-S13;A;5;0;3;0;2;0
31;2020-S13;B;232;22;47;4;185;18
31;2020-S13;C;183;35;72;20;111;15
31;2020-S13;D;27;3;19;3;8;0
31;2020-S13;E;58;10;27;5;31;5
31;2020-S14;0;707;54;237;27;470;27
31;2020-S14;A;13;1;7;1;6;0
31;2020-S14;B;341;24;107;12;234;12
31;2020-S14;C;240;9;75;6;165;3
31;2020-S14;D;44;9;23;4;21;5
31;2020-S14;E;65;10;24;4;41;6
31;2020-S15;0;1299;50;385;18;914;32
31;2020-S15;A;8;0;2;0;6;0
31;2020-S15;B;450;22;130;7;320;15
31;2020-S15;C;390;16;115;10;275;6
31;2020-S15;D;112;2;46;0;66;2
31;2020-S15;E;332;10;92;1;240;9
31;2020-S16;0;923;18;296;6;627;12
31;2020-S16;A;18;0;10;0;8;0
31;2020-S16;B;377;8;90;4;287;4
31;2020-S16;C;277;6;100;2;177;4
31;2020-S16;D;71;1;36;0;35;1
31;2020-S16;E;171;3;55;0;116;3
31;2020-S17;0;1260;30;413;11;847;19
31;2020-S17;A;23;0;11;0;12;0
31;2020-S17;B;458;12;142;5;316;7
31;2020-S17;C;323;6;113;3;210;3
31;2020-S17;D;106;3;59;2;47;1
31;2020-S17;E;345;9;87;1;258;8
31;2020-S18;0;839;13;300;4;539;9
31;2020-S18;A;26;0;11;0;15;0
31;2020-S18;B;369;4;125;1;244;3
31;2020-S18;C;207;4;80;1;127;3
31;2020-S18;D;79;3;35;2;44;1
31;2020-S18;E;150;2;43;0;107;2
31;2020-S19;0;1360;30;470;10;890;20
31;2020-S19;A;57;0;27;0;30;0
31;2020-S19;B;529;17;200;6;329;11
31;2020-S19;C;406;8;145;3;261;5
31;2020-S19;D;84;1;41;0;43;1
31;2020-S19;E;275;3;56;1;219;2
31;2020-S20;0;2112;38;792;21;1320;17
31;2020-S20;A;125;0;63;0;62;0
31;2020-S20;B;858;20;309;7;549;13
31;2020-S20;C;569;5;239;3;330;2
31;2020-S20;D;168;1;80;0;88;1
31;2020-S20;E;363;3;75;2;288;1
31;2020-S21;0;1698;6;752;2;946;4
31;2020-S21;A;145;0;87;0;58;0
31;2020-S21;B;666;4;276;2;390;2
31;2020-S21;C;491;1;215;0;276;1
31;2020-S21;D;172;1;85;0;87;1
31;2020-S21;E;180;0;72;0;108;0
32;2020-S11;0;0;0;0;0;0;0
32;2020-S11;A;0;0;0;0;0;0
32;2020-S11;B;0;0;0;0;0;0
32;2020-S11;C;0;0;0;0;0;0
32;2020-S11;D;0;0;0;0;0;0
32;2020-S11;E;0;0;0;0;0;0
32;2020-S12;0;39;9;10;2;29;7
32;2020-S12;A;0;0;0;0;0;0
32;2020-S12;B;16;2;3;0;13;2
32;2020-S12;C;6;2;0;0;6;2
32;2020-S12;D;4;0;2;0;2;0
32;2020-S12;E;13;5;5;2;8;3
32;2020-S13;0;140;19;37;6;103;13
32;2020-S13;A;2;0;1;0;1;0
32;2020-S13;B;56;7;9;2;47;5
32;2020-S13;C;42;7;13;2;29;5
32;2020-S13;D;7;1;3;0;4;1
32;2020-S13;E;33;4;11;2;22;2
32;2020-S14;0;232;24;48;7;184;17
32;2020-S14;A;1;0;0;0;1;0
32;2020-S14;B;94;6;12;1;82;5
32;2020-S14;C;78;5;13;0;65;5
32;2020-S14;D;18;3;7;1;11;2
32;2020-S14;E;41;10;16;5;25;5
32;2020-S15;0;160;23;26;2;134;21
32;2020-S15;A;1;0;1;0;0;0
32;2020-S15;B;59;5;5;0;54;5
32;2020-S15;C;67;9;10;1;57;8
32;2020-S15;D;11;1;5;1;6;0
32;2020-S15;E;22;8;5;0;17;8
32;2020-S16;0;166;27;41;7;125;20
32;2020-S16;A;2;0;1;0;1;0
32;2020-S16;B;57;7;9;0;48;7
32;2020-S16;C;50;6;12;1;38;5
32;2020-S16;D;7;0;5;0;2;0
32;2020-S16;E;50;14;14;6;36;8
32;2020-S17;0;233;16;50;4;183;12
32;2020-S17;A;2;0;0;0;2;0
32;2020-S17;B;69;2;15;1;54;1
32;2020-S17;C;110;4;19;0;91;4
32;2020-S17;D;12;0;6;0;6;0
32;2020-S17;E;40;10;10;3;30;7
32;2020-S18;0;362;21;105;10;257;11
32;2020-S18;A;1;0;0;0;1;0
32;2020-S18;B;84;2;23;1;61;1
32;2020-S18;C;108;4;32;0;76;4
32;2020-S18;D;19;1;9;1;10;0
32;2020-S18;E;150;14;41;8;109;6
32;2020-S19;0;150;11;52;2;97;9
32;2020-S19;A;4;0;3;0;0;0
32;2020-S19;B;43;0;20;0;23;0
32;2020-S19;C;49;6;16;0;33;6
32;2020-S19;D;12;0;4;0;8;0
32;2020-S19;E;41;5;9;2;32;3
32;2020-S20;0;362;5;128;0;234;5
32;2020-S20;A;12;0;7;0;5;0
32;2020-S20;B;96;0;34;0;62;0
32;2020-S20;C;109;2;39;0;70;2
32;2020-S20;D;40;0;17;0;23;0
32;2020-S20;E;104;3;31;0;73;3
32;2020-S21;0;569;27;154;9;414;18
32;2020-S21;A;17;0;9;0;7;0
32;2020-S21;B;198;5;44;1;154;4
32;2020-S21;C;193;7;46;1;147;6
32;2020-S21;D;31;2;19;1;12;1
32;2020-S21;E;129;13;36;6;93;7
33;2020-S11;0;25;0;11;0;14;0
33;2020-S11;A;2;0;1;0;1;0
33;2020-S11;B;9;0;3;0;6;0
33;2020-S11;C;12;0;6;0;6;0
33;2020-S11;D;1;0;0;0;1;0
33;2020-S11;E;1;0;1;0;0;0
33;2020-S12;0;320;25;109;16;211;9
33;2020-S12;A;6;0;3;0;3;0
33;2020-S12;B;162;9;43;6;119;3
33;2020-S12;C;93;12;40;9;53;3
33;2020-S12;D;20;2;13;1;7;1
33;2020-S12;E;36;2;9;0;27;2
33;2020-S13;0;883;94;255;38;628;56
33;2020-S13;A;8;0;4;0;4;0
33;2020-S13;B;417;39;93;11;324;28
33;2020-S13;C;289;37;87;18;202;19
33;2020-S13;D;50;10;26;5;24;5
33;2020-S13;E;117;7;44;3;73;4
33;2020-S14;0;1071;115;302;43;769;72
33;2020-S14;A;11;2;4;0;7;2
33;2020-S14;B;521;43;127;15;394;28
33;2020-S14;C;349;47;102;17;247;30
33;2020-S14;D;86;8;36;5;50;3
33;2020-S14;E;103;15;33;6;70;9
33;2020-S15;0;869;63;280;18;589;45
33;2020-S15;A;20;0;13;0;7;0
33;2020-S15;B;351;18;97;4;254;14
33;2020-S15;C;291;32;95;10;196;22
33;2020-S15;D;62;5;30;2;32;3
33;2020-S15;E;139;8;44;2;95;6
33;2020-S16;0;797;28;247;8;550;20
33;2020-S16;A;15;1;10;1;5;0
33;2020-S16;B;345;10;90;2;255;8
33;2020-S16;C;237;11;76;3;161;8
33;2020-S16;D;58;4;24;2;34;2
33;2020-S16;E;142;2;47;0;95;2
33;2020-S17;0;861;13;233;7;628;6
33;2020-S17;A;15;1;9;1;6;0
33;2020-S17;B;259;6;72;4;187;2
33;2020-S17;C;178;2;50;1;128;1
33;2020-S17;D;69;0;30;0;39;0
33;2020-S17;E;339;4;72;1;267;3
33;2020-S18;0;658;1;189;0;469;1
33;2020-S18;A;8;0;5;0;3;0
33;2020-S18;B;211;0;48;0;163;0
33;2020-S18;C;155;1;44;0;111;1
33;2020-S18;D;57;0;30;0;27;0
33;2020-S18;E;223;0;61;0;162;0
33;2020-S19;0;671;5;249;1;422;4
33;2020-S19;A;23;0;14;0;9;0
33;2020-S19;B;331;2;125;1;206;1
33;2020-S19;C;174;2;58;0;116;2
33;2020-S19;D;43;1;20;0;23;1
33;2020-S19;E;93;0;28;0;65;0
33;2020-S20;0;1086;3;471;0;615;3
33;2020-S20;A;80;0;44;0;36;0
33;2020-S20;B;436;0;179;0;257;0
33;2020-S20;C;284;0;140;0;144;0
33;2020-S20;D;94;1;44;0;50;1
33;2020-S20;E;189;2;63;0;126;2
33;2020-S21;0;651;1;336;0;315;1
33;2020-S21;A;51;0;32;0;19;0
33;2020-S21;B;253;0;136;0;117;0
33;2020-S21;C;207;1;106;0;101;1
33;2020-S21;D;41;0;26;0;15;0
33;2020-S21;E;97;0;35;0;62;0
34;2020-S11;0;4;0;1;0;3;0
34;2020-S11;A;0;0;0;0;0;0
34;2020-S11;B;4;0;1;0;3;0
34;2020-S11;C;0;0;0;0;0;0
34;2020-S11;D;0;0;0;0;0;0
34;2020-S11;E;0;0;0;0;0;0
34;2020-S12;0;598;117;223;45;375;72
34;2020-S12;A;11;3;9;3;2;0
34;2020-S12;B;199;29;51;9;148;20
34;2020-S12;C;155;25;61;15;94;10
34;2020-S12;D;57;14;34;9;23;5
34;2020-S12;E;175;46;67;9;108;37
34;2020-S13;0;2064;365;751;167;1309;197
34;2020-S13;A;19;0;14;0;3;0
34;2020-S13;B;905;152;270;67;633;84
34;2020-S13;C;675;117;247;47;428;70
34;2020-S13;D;177;46;102;28;75;18
34;2020-S13;E;287;50;118;25;169;25
34;2020-S14;0;2599;274;889;114;1705;159
34;2020-S14;A;25;0;13;0;10;0
34;2020-S14;B;1056;91;296;29;757;61
34;2020-S14;C;887;99;283;43;604;56
34;2020-S14;D;215;34;111;16;104;18
34;2020-S14;E;411;49;184;26;227;23
34;2020-S15;0;3920;142;1238;58;2674;84
34;2020-S15;A;30;0;12;0;12;0
34;2020-S15;B;1556;48;448;17;1106;31
34;2020-S15;C;1421;47;416;20;1005;27
34;2020-S15;D;291;14;153;7;138;7
34;2020-S15;E;620;33;209;14;411;19
34;2020-S16;0;4178;106;1343;38;2822;68
34;2020-S16;A;39;1;21;1;8;0
34;2020-S16;B;1322;32;382;13;938;19
34;2020-S16;C;1272;31;416;12;856;19
34;2020-S16;D;360;6;186;3;174;3
34;2020-S16;E;1184;36;338;9;845;27
34;2020-S17;0;4512;90;1721;32;2776;58
34;2020-S17;A;47;0;20;0;17;0
34;2020-S17;B;1523;25;537;10;982;15
34;2020-S17;C;1409;18;574;5;834;13
34;2020-S17;D;432;9;214;3;218;6
34;2020-S17;E;1101;38;376;14;725;24
34;2020-S18;0;3055;36;1129;20;1914;16
34;2020-S18;A;35;0;12;0;13;0
34;2020-S18;B;753;13;290;9;461;4
34;2020-S18;C;727;8;313;6;414;2
34;2020-S18;D;354;4;177;1;177;3
34;2020-S18;E;1180;11;335;4;845;7
34;2020-S19;0;4254;70;1739;26;2482;44
34;2020-S19;A;108;0;37;0;41;0
34;2020-S19;B;1267;15;499;4;765;11
34;2020-S19;C;1208;14;534;7;674;7
34;2020-S19;D;519;9;285;5;234;4
34;2020-S19;E;1143;32;379;10;764;22
34;2020-S20;0;5680;30;2439;11;3182;19
34;2020-S20;A;249;0;116;0;86;0
34;2020-S20;B;1799;9;720;2;1069;7
34;2020-S20;C;1554;5;694;2;859;3
34;2020-S20;D;882;2;463;1;419;1
34;2020-S20;E;1189;14;444;6;745;8
34;2020-S21;0;5075;26;2285;10;2725;16
34;2020-S21;A;234;0;89;0;92;0
34;2020-S21;B;1621;3;673;1;936;2
34;2020-S21;C;1383;1;653;0;730;1
34;2020-S21;D;801;2;418;2;383;0
34;2020-S21;E;1010;20;430;7;580;13
35;2020-S11;0;0;0;0;0;0;0
35;2020-S11;A;0;0;0;0;0;0
35;2020-S11;B;0;0;0;0;0;0
35;2020-S11;C;0;0;0;0;0;0
35;2020-S11;D;0;0;0;0;0;0
35;2020-S11;E;0;0;0;0;0;0
35;2020-S12;0;7;0;0;0;7;0
35;2020-S12;A;1;0;0;0;1;0
35;2020-S12;B;2;0;0;0;2;0
35;2020-S12;C;3;0;0;0;3;0
35;2020-S12;D;1;0;0;0;1;0
35;2020-S12;E;0;0;0;0;0;0
35;2020-S13;0;17;4;8;2;9;2
35;2020-S13;A;0;0;0;0;0;0
35;2020-S13;B;5;0;2;0;3;0
35;2020-S13;C;10;4;4;2;6;2
35;2020-S13;D;1;0;1;0;0;0
35;2020-S13;E;1;0;1;0;0;0
35;2020-S14;0;25;3;3;0;22;3
35;2020-S14;A;0;0;0;0;0;0
35;2020-S14;B;12;1;0;0;12;1
35;2020-S14;C;9;0;1;0;8;0
35;2020-S14;D;0;0;0;0;0;0
35;2020-S14;E;4;2;2;0;2;2
35;2020-S15;0;10;0;3;0;7;0
35;2020-S15;A;0;0;0;0;0;0
35;2020-S15;B;0;0;0;0;0;0
35;2020-S15;C;6;0;3;0;3;0
35;2020-S15;D;2;0;0;0;2;0
35;2020-S15;E;2;0;0;0;2;0
35;2020-S16;0;4;0;2;0;2;0
35;2020-S16;A;0;0;0;0;0;0
35;2020-S16;B;2;0;1;0;1;0
35;2020-S16;C;1;0;0;0;1;0
35;2020-S16;D;1;0;1;0;0;0
35;2020-S16;E;0;0;0;0;0;0
35;2020-S17;0;183;2;34;1;149;1
35;2020-S17;A;1;0;0;0;1;0
35;2020-S17;B;113;1;13;0;100;1
35;2020-S17;C;58;0;14;0;44;0
35;2020-S17;D;4;1;4;1;0;0
35;2020-S17;E;7;0;3;0;4;0
35;2020-S18;0;42;0;11;0;31;0
35;2020-S18;A;0;0;0;0;0;0
35;2020-S18;B;22;0;7;0;15;0
35;2020-S18;C;17;0;2;0;15;0
35;2020-S18;D;2;0;1;0;1;0
35;2020-S18;E;1;0;1;0;0;0
35;2020-S19;0;23;0;8;0;15;0
35;2020-S19;A;2;0;2;0;0;0
35;2020-S19;B;14;0;3;0;11;0
35;2020-S19;C;4;0;3;0;1;0
35;2020-S19;D;0;0;0;0;0;0
35;2020-S19;E;3;0;0;0;3;0
35;2020-S20;0;57;1;28;1;29;0
35;2020-S20;A;7;0;5;0;2;0
35;2020-S20;B;28;0;14;0;14;0
35;2020-S20;C;19;1;7;1;12;0
35;2020-S20;D;3;0;2;0;1;0
35;2020-S20;E;0;0;0;0;0;0
35;2020-S21;0;50;0;17;0;33;0
35;2020-S21;A;12;0;4;0;8;0
35;2020-S21;B;20;0;8;0;12;0
35;2020-S21;C;15;0;5;0;10;0
35;2020-S21;D;1;0;0;0;1;0
35;2020-S21;E;2;0;0;0;2;0
36;2020-S11;0;0;0;0;0;0;0
36;2020-S11;A;0;0;0;0;0;0
36;2020-S11;B;0;0;0;0;0;0
36;2020-S11;C;0;0;0;0;0;0
36;2020-S11;D;0;0;0;0;0;0
36;2020-S11;E;0;0;0;0;0;0
36;2020-S12;0;17;3;6;2;11;1
36;2020-S12;A;1;0;1;0;0;0
36;2020-S12;B;11;0;3;0;8;0
36;2020-S12;C;4;3;2;2;2;1
36;2020-S12;D;0;0;0;0;0;0
36;2020-S12;E;1;0;0;0;1;0
36;2020-S13;0;162;45;49;13;113;32
36;2020-S13;A;2;0;1;0;1;0
36;2020-S13;B;60;11;8;1;52;10
36;2020-S13;C;52;15;15;2;37;13
36;2020-S13;D;9;3;8;3;1;0
36;2020-S13;E;38;16;17;7;21;9
36;2020-S14;0;261;74;81;23;180;51
36;2020-S14;A;1;0;1;0;0;0
36;2020-S14;B;93;18;24;3;69;15
36;2020-S14;C;78;22;18;6;60;16
36;2020-S14;D;14;3;6;1;8;2
36;2020-S14;E;75;31;32;13;43;18
36;2020-S15;0;354;83;100;21;253;61
36;2020-S15;A;2;0;0;0;2;0
36;2020-S15;B;89;18;17;1;71;16
36;2020-S15;C;95;27;22;4;73;23
36;2020-S15;D;27;7;16;6;11;1
36;2020-S15;E;141;31;45;10;96;21
36;2020-S16;0;300;55;79;18;221;37
36;2020-S16;A;2;0;1;0;1;0
36;2020-S16;B;110;13;20;1;90;12
36;2020-S16;C;100;16;25;6;75;10
36;2020-S16;D;16;3;5;2;11;1
36;2020-S16;E;72;23;28;9;44;14
36;2020-S17;0;614;81;134;21;480;60
36;2020-S17;A;2;0;1;0;1;0
36;2020-S17;B;132;14;21;4;111;10
36;2020-S17;C;130;18;28;3;102;15
36;2020-S17;D;40;4;20;3;20;1
36;2020-S17;E;308;45;63;11;245;34
36;2020-S18;0;511;14;123;4;388;10
36;2020-S18;A;4;0;2;0;2;0
36;2020-S18;B;142;2;29;0;113;2
36;2020-S18;C;125;5;30;1;95;4
36;2020-S18;D;23;0;11;0;12;0
36;2020-S18;E;216;7;50;3;166;4
36;2020-S19;0;460;6;147;1;313;5
36;2020-S19;A;8;0;1;0;7;0
36;2020-S19;B;160;3;49;0;111;3
36;2020-S19;C;158;0;59;0;99;0
36;2020-S19;D;30;0;13;0;17;0
36;2020-S19;E;85;3;23;1;62;2
36;2020-S20;0;425;9;161;2;264;7
36;2020-S20;A;28;2;19;0;9;2
36;2020-S20;B;154;2;50;1;104;1
36;2020-S20;C;144;2;47;0;97;2
36;2020-S20;D;40;1;19;1;21;0
36;2020-S20;E;59;2;26;0;33;2
36;2020-S21;0;439;2;167;1;272;1
36;2020-S21;A;21;0;16;0;5;0
36;2020-S21;B;128;1;52;1;76;0
36;2020-S21;C;134;0;46;0;88;0
36;2020-S21;D;56;1;29;0;27;1
36;2020-S21;E;100;0;24;0;76;0
37;2020-S11;0;0;0;0;0;0;0
37;2020-S11;A;0;0;0;0;0;0
37;2020-S11;B;0;0;0;0;0;0
37;2020-S11;C;0;0;0;0;0;0
37;2020-S11;D;0;0;0;0;0;0
37;2020-S11;E;0;0;0;0;0;0
37;2020-S12;0;45;3;13;2;32;1
37;2020-S12;A;0;0;0;0;0;0
37;2020-S12;B;17;2;4;1;13;1
37;2020-S12;C;15;1;3;1;12;0
37;2020-S12;D;3;0;2;0;1;0
37;2020-S12;E;10;0;4;0;6;0
37;2020-S13;0;179;31;60;12;119;19
37;2020-S13;A;2;0;1;0;1;0
37;2020-S13;B;78;12;25;4;53;8
37;2020-S13;C;66;13;23;5;43;8
37;2020-S13;D;13;3;4;1;9;2
37;2020-S13;E;20;3;7;2;13;1
37;2020-S14;0;167;23;51;9;116;14
37;2020-S14;A;2;0;2;0;0;0
37;2020-S14;B;71;10;20;3;51;7
37;2020-S14;C;57;12;18;5;39;7
37;2020-S14;D;15;1;6;1;9;0
37;2020-S14;E;22;0;5;0;17;0
37;2020-S15;0;222;23;76;8;146;15
37;2020-S15;A;3;0;3;0;0;0
37;2020-S15;B;97;13;33;3;64;10
37;2020-S15;C;67;6;20;3;47;3
37;2020-S15;D;15;0;7;0;8;0
37;2020-S15;E;40;4;13;2;27;2
37;2020-S16;0;546;6;128;0;418;6
37;2020-S16;A;5;0;2;0;3;0
37;2020-S16;B;175;3;36;0;139;3
37;2020-S16;C;114;3;25;0;89;3
37;2020-S16;D;28;0;10;0;18;0
37;2020-S16;E;222;0;54;0;168;0
37;2020-S17;0;561;5;136;0;425;5
37;2020-S17;A;5;0;2;0;3;0
37;2020-S17;B;149;1;36;0;113;1
37;2020-S17;C;106;3;19;0;87;3
37;2020-S17;D;21;0;6;0;15;0
37;2020-S17;E;280;1;73;0;207;1
37;2020-S18;0;627;11;149;4;478;7
37;2020-S18;A;5;0;1;0;4;0
37;2020-S18;B;156;3;32;1;124;2
37;2020-S18;C;131;0;31;0;100;0
37;2020-S18;D;35;2;15;1;20;1
37;2020-S18;E;296;6;69;2;227;4
37;2020-S19;0;479;10;151;4;328;6
37;2020-S19;A;9;0;2;0;7;0
37;2020-S19;B;188;2;60;2;128;0
37;2020-S19;C;152;4;42;2;110;2
37;2020-S19;D;33;1;18;0;15;1
37;2020-S19;E;97;3;29;0;68;3
37;2020-S20;0;557;5;217;3;340;2
37;2020-S20;A;25;0;15;0;10;0
37;2020-S20;B;240;5;99;3;141;2
37;2020-S20;C;144;0;53;0;91;0
37;2020-S20;D;46;0;21;0;25;0
37;2020-S20;E;100;0;28;0;72;0
37;2020-S21;0;591;1;200;0;391;1
37;2020-S21;A;21;0;12;0;9;0
37;2020-S21;B;227;0;86;0;141;0
37;2020-S21;C;158;1;56;0;102;1
37;2020-S21;D;39;0;11;0;28;0
37;2020-S21;E;146;0;35;0;111;0
38;2020-S11;0;0;0;0;0;0;0
38;2020-S11;A;0;0;0;0;0;0
38;2020-S11;B;0;0;0;0;0;0
38;2020-S11;C;0;0;0;0;0;0
38;2020-S11;D;0;0;0;0;0;0
38;2020-S11;E;0;0;0;0;0;0
38;2020-S12;0;363;34;95;15;268;19
38;2020-S12;A;7;0;2;0;5;0
38;2020-S12;B;162;12;28;5;134;7
38;2020-S12;C;126;15;39;6;87;9
38;2020-S12;D;27;2;11;0;16;2
38;2020-S12;E;40;5;15;4;25;1
38;2020-S13;0;527;46;148;17;379;29
38;2020-S13;A;4;0;2;0;2;0
38;2020-S13;B;219;14;46;4;173;10
38;2020-S13;C;197;21;57;9;140;12
38;2020-S13;D;41;6;20;2;21;4
38;2020-S13;E;66;5;23;2;43;3
38;2020-S14;0;219;19;49;3;170;16
38;2020-S14;A;2;0;0;0;2;0
38;2020-S14;B;96;6;14;0;82;6
38;2020-S14;C;72;9;19;1;53;8
38;2020-S14;D;24;3;10;2;14;1
38;2020-S14;E;25;1;6;0;19;1
38;2020-S15;0;153;26;48;6;104;20
38;2020-S15;A;3;0;1;0;1;0
38;2020-S15;B;63;10;14;0;49;10
38;2020-S15;C;59;11;22;2;37;9
38;2020-S15;D;17;3;5;2;12;1
38;2020-S15;E;11;2;6;2;5;0
38;2020-S16;0;116;9;39;2;77;7
38;2020-S16;A;4;0;2;0;2;0
38;2020-S16;B;40;4;9;0;31;4
38;2020-S16;C;43;4;15;2;28;2
38;2020-S16;D;16;1;10;0;6;1
38;2020-S16;E;13;0;3;0;10;0
38;2020-S17;0;107;2;43;0;64;2
38;2020-S17;A;3;0;1;0;2;0
38;2020-S17;B;42;1;12;0;30;1
38;2020-S17;C;31;1;12;0;19;1
38;2020-S17;D;21;0;12;0;9;0
38;2020-S17;E;10;0;6;0;4;0
38;2020-S18;0;117;1;58;0;59;1
38;2020-S18;A;7;0;4;0;3;0
38;2020-S18;B;52;0;26;0;26;0
38;2020-S18;C;40;1;19;0;21;1
38;2020-S18;D;10;0;4;0;6;0
38;2020-S18;E;8;0;5;0;3;0
38;2020-S19;0;4;0;1;0;3;0
38;2020-S19;A;0;0;0;0;0;0
38;2020-S19;B;1;0;0;0;1;0
38;2020-S19;C;2;0;0;0;2;0
38;2020-S19;D;1;0;1;0;0;0
38;2020-S19;E;0;0;0;0;0;0
38;2020-S20;0;32;0;16;0;16;0
38;2020-S20;A;2;0;2;0;0;0
38;2020-S20;B;9;0;3;0;6;0
38;2020-S20;C;11;0;7;0;4;0
38;2020-S20;D;8;0;3;0;5;0
38;2020-S20;E;2;0;1;0;1;0
38;2020-S21;0;133;1;64;0;69;1
38;2020-S21;A;6;0;2;0;4;0
38;2020-S21;B;56;1;29;0;27;1
38;2020-S21;C;43;0;20;0;23;0
38;2020-S21;D;18;0;8;0;10;0
38;2020-S21;E;10;0;5;0;5;0
39;2020-S11;0;0;0;0;0;0;0
39;2020-S11;A;0;0;0;0;0;0
39;2020-S11;B;0;0;0;0;0;0
39;2020-S11;C;0;0;0;0;0;0
39;2020-S11;D;0;0;0;0;0;0
39;2020-S11;E;0;0;0;0;0;0
39;2020-S12;0;6;1;3;1;3;0
39;2020-S12;A;0;0;0;0;0;0
39;2020-S12;B;3;0;1;0;2;0
39;2020-S12;C;2;1;1;1;1;0
39;2020-S12;D;0;0;0;0;0;0
39;2020-S12;E;1;0;1;0;0;0
39;2020-S13;0;23;10;10;3;13;7
39;2020-S13;A;0;0;0;0;0;0
39;2020-S13;B;5;3;0;0;5;3
39;2020-S13;C;6;2;3;0;3;2
39;2020-S13;D;3;1;3;1;0;0
39;2020-S13;E;9;4;4;2;5;2
39;2020-S14;0;112;20;19;4;93;16
39;2020-S14;A;1;0;1;0;0;0
39;2020-S14;B;41;10;5;2;36;8
39;2020-S14;C;47;8;6;1;41;7
39;2020-S14;D;6;0;2;0;4;0
39;2020-S14;E;17;2;5;1;12;1
39;2020-S15;0;262;54;77;11;185;43
39;2020-S15;A;1;0;0;0;1;0
39;2020-S15;B;40;6;12;1;28;5
39;2020-S15;C;39;10;13;1;26;9
39;2020-S15;D;22;2;9;1;13;1
39;2020-S15;E;160;36;43;8;117;28
39;2020-S16;0;179;15;47;4;132;11
39;2020-S16;A;2;0;0;0;2;0
39;2020-S16;B;75;8;15;1;60;7
39;2020-S16;C;74;4;16;1;58;3
39;2020-S16;D;12;0;7;0;5;0
39;2020-S16;E;16;3;9;2;7;1
39;2020-S17;0;324;26;85;10;239;16
39;2020-S17;A;0;0;0;0;0;0
39;2020-S17;B;121;9;29;2;92;7
39;2020-S17;C;91;8;22;4;69;4
39;2020-S17;D;22;1;10;0;12;1
39;2020-S17;E;90;8;24;4;66;4
39;2020-S18;0;206;5;49;2;157;3
39;2020-S18;A;6;0;4;0;2;0
39;2020-S18;B;60;2;16;1;44;1
39;2020-S18;C;44;1;11;0;33;1
39;2020-S18;D;20;0;9;0;11;0
39;2020-S18;E;76;2;9;1;67;1
39;2020-S19;0;130;17;47;5;83;12
39;2020-S19;A;2;2;2;2;0;0
39;2020-S19;B;29;4;12;0;17;4
39;2020-S19;C;27;1;9;1;18;0
39;2020-S19;D;16;2;8;1;8;1
39;2020-S19;E;56;8;16;1;40;7
39;2020-S20;0;116;1;50;0;66;1
39;2020-S20;A;7;0;1;0;6;0
39;2020-S20;B;46;0;19;0;27;0
39;2020-S20;C;34;0;15;0;19;0
39;2020-S20;D;15;0;9;0;6;0
39;2020-S20;E;14;1;6;0;8;1
39;2020-S21;0;65;0;23;0;42;0
39;2020-S21;A;8;0;5;0;3;0
39;2020-S21;B;26;0;9;0;17;0
39;2020-S21;C;20;0;7;0;13;0
39;2020-S21;D;6;0;2;0;4;0
39;2020-S21;E;5;0;0;0;5;0
40;2020-S11;0;0;0;0;0;0;0
40;2020-S11;A;0;0;0;0;0;0
40;2020-S11;B;0;0;0;0;0;0
40;2020-S11;C;0;0;0;0;0;0
40;2020-S11;D;0;0;0;0;0;0
40;2020-S11;E;0;0;0;0;0;0
40;2020-S12;0;19;1;4;1;15;0
40;2020-S12;A;0;0;0;0;0;0
40;2020-S12;B;10;0;1;0;9;0
40;2020-S12;C;6;0;1;0;5;0
40;2020-S12;D;2;1;1;1;1;0
40;2020-S12;E;1;0;1;0;0;0
40;2020-S13;0;28;2;7;0;21;2
40;2020-S13;A;0;0;0;0;0;0
40;2020-S13;B;14;1;2;0;12;1
40;2020-S13;C;10;1;3;0;7;1
40;2020-S13;D;2;0;1;0;1;0
40;2020-S13;E;2;0;1;0;1;0
40;2020-S14;0;155;12;37;5;118;7
40;2020-S14;A;0;0;0;0;0;0
40;2020-S14;B;67;2;11;0;56;2
40;2020-S14;C;60;4;13;2;47;2
40;2020-S14;D;12;2;6;2;6;0
40;2020-S14;E;16;4;7;1;9;3
40;2020-S15;0;91;3;30;1;61;2
40;2020-S15;A;0;0;0;0;0;0
40;2020-S15;B;32;0;8;0;24;0
40;2020-S15;C;36;2;14;1;22;1
40;2020-S15;D;7;1;1;0;6;1
40;2020-S15;E;16;0;7;0;9;0
40;2020-S16;0;42;1;16;1;26;0
40;2020-S16;A;0;0;0;0;0;0
40;2020-S16;B;19;0;9;0;10;0
40;2020-S16;C;14;1;3;1;11;0
40;2020-S16;D;4;0;2;0;2;0
40;2020-S16;E;5;0;2;0;3;0
40;2020-S17;0;33;1;16;1;17;0
40;2020-S17;A;0;0;0;0;0;0
40;2020-S17;B;13;0;4;0;9;0
40;2020-S17;C;12;1;7;1;5;0
40;2020-S17;D;3;0;3;0;0;0
40;2020-S17;E;5;0;2;0;3;0
40;2020-S18;0;62;1;23;0;39;1
40;2020-S18;A;1;0;1;0;0;0
40;2020-S18;B;25;1;7;0;18;1
40;2020-S18;C;22;0;8;0;14;0
40;2020-S18;D;8;0;5;0;3;0
40;2020-S18;E;6;0;2;0;4;0
40;2020-S19;0;71;0;37;0;34;0
40;2020-S19;A;1;0;1;0;0;0
40;2020-S19;B;34;0;19;0;15;0
40;2020-S19;C;22;0;10;0;12;0
40;2020-S19;D;6;0;4;0;2;0
40;2020-S19;E;8;0;3;0;5;0
40;2020-S20;0;182;0;74;0;108;0
40;2020-S20;A;9;0;7;0;2;0
40;2020-S20;B;79;0;30;0;49;0
40;2020-S20;C;62;0;22;0;40;0
40;2020-S20;D;24;0;12;0;12;0
40;2020-S20;E;8;0;3;0;5;0
40;2020-S21;0;92;2;41;1;51;1
40;2020-S21;A;4;0;2;0;2;0
40;2020-S21;B;41;0;18;0;23;0
40;2020-S21;C;32;2;16;1;16;1
40;2020-S21;D;9;0;4;0;5;0
40;2020-S21;E;5;0;0;0;5;0
41;2020-S11;0;0;0;0;0;0;0
41;2020-S11;A;0;0;0;0;0;0
41;2020-S11;B;0;0;0;0;0;0
41;2020-S11;C;0;0;0;0;0;0
41;2020-S11;D;0;0;0;0;0;0
41;2020-S11;E;0;0;0;0;0;0
41;2020-S12;0;6;4;3;2;3;2
41;2020-S12;A;0;0;0;0;0;0
41;2020-S12;B;2;1;1;0;1;1
41;2020-S12;C;4;3;2;2;2;1
41;2020-S12;D;0;0;0;0;0;0
41;2020-S12;E;0;0;0;0;0;0
41;2020-S13;0;89;20;17;8;72;12
41;2020-S13;A;1;0;0;0;1;0
41;2020-S13;B;33;9;5;3;28;6
41;2020-S13;C;31;6;6;2;25;4
41;2020-S13;D;2;0;0;0;2;0
41;2020-S13;E;22;5;6;3;16;2
41;2020-S14;0;45;8;18;3;27;5
41;2020-S14;A;0;0;0;0;0;0
41;2020-S14;B;14;0;5;0;9;0
41;2020-S14;C;15;5;6;2;9;3
41;2020-S14;D;4;1;2;1;2;0
41;2020-S14;E;12;2;5;0;7;2
41;2020-S15;0;68;6;26;3;42;3
41;2020-S15;A;0;0;0;0;0;0
41;2020-S15;B;16;1;5;1;11;0
41;2020-S15;C;21;1;7;0;14;1
41;2020-S15;D;6;0;3;0;3;0
41;2020-S15;E;25;4;11;2;14;2
41;2020-S16;0;37;0;13;0;24;0
41;2020-S16;A;0;0;0;0;0;0
41;2020-S16;B;12;0;4;0;8;0
41;2020-S16;C;7;0;0;0;7;0
41;2020-S16;D;4;0;1;0;3;0
41;2020-S16;E;14;0;8;0;6;0
41;2020-S17;0;73;1;20;0;53;1
41;2020-S17;A;1;0;1;0;0;0
41;2020-S17;B;29;0;5;0;24;0
41;2020-S17;C;28;1;10;0;18;1
41;2020-S17;D;2;0;0;0;2;0
41;2020-S17;E;13;0;4;0;9;0
41;2020-S18;0;82;1;28;0;54;1
41;2020-S18;A;0;0;0;0;0;0
41;2020-S18;B;20;1;6;0;14;1
41;2020-S18;C;18;0;5;0;13;0
41;2020-S18;D;5;0;3;0;2;0
41;2020-S18;E;39;0;14;0;25;0
41;2020-S19;0;136;2;55;0;81;2
41;2020-S19;A;3;0;1;0;2;0
41;2020-S19;B;53;0;18;0;35;0
41;2020-S19;C;48;0;25;0;23;0
41;2020-S19;D;8;0;3;0;5;0
41;2020-S19;E;24;2;8;0;16;2
41;2020-S20;0;469;8;185;2;284;6
41;2020-S20;A;19;0;11;0;8;0
41;2020-S20;B;162;5;64;1;98;4
41;2020-S20;C;135;2;49;1;86;1
41;2020-S20;D;36;0;21;0;15;0
41;2020-S20;E;117;1;40;0;77;1
41;2020-S21;0;269;4;114;1;155;3
41;2020-S21;A;19;0;10;0;9;0
41;2020-S21;B;97;2;39;0;58;2
41;2020-S21;C;82;2;34;1;48;1
41;2020-S21;D;38;0;18;0;20;0
41;2020-S21;E;33;0;13;0;20;0
42;2020-S11;0;0;0;0;0;0;0
42;2020-S11;A;0;0;0;0;0;0
42;2020-S11;B;0;0;0;0;0;0
42;2020-S11;C;0;0;0;0;0;0
42;2020-S11;D;0;0;0;0;0;0
42;2020-S11;E;0;0;0;0;0;0
42;2020-S12;0;6;0;2;0;4;0
42;2020-S12;A;1;0;1;0;0;0
42;2020-S12;B;4;0;0;0;4;0
42;2020-S12;C;1;0;1;0;0;0
42;2020-S12;D;0;0;0;0;0;0
42;2020-S12;E;0;0;0;0;0;0
42;2020-S13;0;31;5;8;3;23;2
42;2020-S13;A;1;0;1;0;0;0
42;2020-S13;B;11;1;2;0;9;1
42;2020-S13;C;8;0;1;0;7;0
42;2020-S13;D;6;3;3;2;3;1
42;2020-S13;E;5;1;1;1;4;0
42;2020-S14;0;22;4;6;1;16;3
42;2020-S14;A;0;0;0;0;0;0
42;2020-S14;B;6;1;1;0;5;1
42;2020-S14;C;8;1;3;0;5;1
42;2020-S14;D;1;0;1;0;0;0
42;2020-S14;E;7;2;1;1;6;1
42;2020-S15;0;29;4;8;2;21;2
42;2020-S15;A;0;0;0;0;0;0
42;2020-S15;B;8;0;2;0;6;0
42;2020-S15;C;12;2;3;1;9;1
42;2020-S15;D;7;2;1;1;6;1
42;2020-S15;E;2;0;2;0;0;0
42;2020-S16;0;74;12;16;2;58;10
42;2020-S16;A;1;0;0;0;1;0
42;2020-S16;B;27;3;2;0;25;3
42;2020-S16;C;26;7;6;1;20;6
42;2020-S16;D;7;0;4;0;3;0
42;2020-S16;E;11;1;4;1;7;0
42;2020-S17;0;235;16;52;5;183;11
42;2020-S17;A;14;4;7;3;7;1
42;2020-S17;B;49;1;7;0;42;1
42;2020-S17;C;35;1;8;1;27;0
42;2020-S17;D;20;1;10;1;10;0
42;2020-S17;E;117;9;20;0;97;9
42;2020-S18;0;148;2;51;0;97;2
42;2020-S18;A;5;0;2;0;3;0
42;2020-S18;B;32;0;16;0;16;0
42;2020-S18;C;23;2;8;0;15;2
42;2020-S18;D;17;0;8;0;9;0
42;2020-S18;E;71;0;17;0;54;0
42;2020-S19;0;108;3;35;2;73;1
42;2020-S19;A;1;0;0;0;1;0
42;2020-S19;B;40;2;14;1;26;1
42;2020-S19;C;30;1;10;1;20;0
42;2020-S19;D;18;0;8;0;10;0
42;2020-S19;E;19;0;3;0;16;0
42;2020-S20;0;49;0;21;0;28;0
42;2020-S20;A;3;0;1;0;2;0
42;2020-S20;B;17;0;10;0;7;0
42;2020-S20;C;14;0;6;0;8;0
42;2020-S20;D;5;0;3;0;2;0
42;2020-S20;E;10;0;1;0;9;0
42;2020-S21;0;7;0;2;0;5;0
42;2020-S21;A;0;0;0;0;0;0
42;2020-S21;B;5;0;1;0;4;0
42;2020-S21;C;1;0;0;0;1;0
42;2020-S21;D;0;0;0;0;0;0
42;2020-S21;E;1;0;1;0;0;0
43;2020-S11;0;0;0;0;0;0;0
43;2020-S11;A;0;0;0;0;0;0
43;2020-S11;B;0;0;0;0;0;0
43;2020-S11;C;0;0;0;0;0;0
43;2020-S11;D;0;0;0;0;0;0
43;2020-S11;E;0;0;0;0;0;0
43;2020-S12;0;16;2;4;1;12;1
43;2020-S12;A;0;0;0;0;0;0
43;2020-S12;B;2;0;1;0;1;0
43;2020-S12;C;4;1;0;0;4;1
43;2020-S12;D;1;0;0;0;1;0
43;2020-S12;E;9;1;3;1;6;0
43;2020-S13;0;71;7;20;4;51;3
43;2020-S13;A;0;0;0;0;0;0
43;2020-S13;B;22;2;1;0;21;2
43;2020-S13;C;15;2;4;1;11;1
43;2020-S13;D;5;0;1;0;4;0
43;2020-S13;E;29;3;14;3;15;0
43;2020-S14;0;90;7;22;0;68;7
43;2020-S14;A;0;0;0;0;0;0
43;2020-S14;B;31;2;5;0;26;2
43;2020-S14;C;31;4;7;0;24;4
43;2020-S14;D;9;1;4;0;5;1
43;2020-S14;E;19;0;6;0;13;0
43;2020-S15;0;69;5;30;1;39;4
43;2020-S15;A;1;0;1;0;0;0
43;2020-S15;B;22;2;10;0;12;2
43;2020-S15;C;20;2;9;0;11;2
43;2020-S15;D;7;1;4;1;3;0
43;2020-S15;E;19;0;6;0;13;0
43;2020-S16;0;89;13;36;5;52;8
43;2020-S16;A;2;0;1;0;0;0
43;2020-S16;B;29;5;6;1;23;4
43;2020-S16;C;18;2;8;0;10;2
43;2020-S16;D;9;1;7;1;2;0
43;2020-S16;E;31;5;14;3;17;2
43;2020-S17;0;145;8;51;3;94;5
43;2020-S17;A;2;0;0;0;2;0
43;2020-S17;B;40;2;10;0;30;2
43;2020-S17;C;45;3;17;2;28;1
43;2020-S17;D;18;0;8;0;10;0
43;2020-S17;E;40;3;16;1;24;2
43;2020-S18;0;71;0;28;0;43;0
43;2020-S18;A;0;0;0;0;0;0
43;2020-S18;B;13;0;2;0;11;0
43;2020-S18;C;18;0;8;0;10;0
43;2020-S18;D;13;0;9;0;4;0
43;2020-S18;E;27;0;9;0;18;0
43;2020-S19;0;117;0;46;0;70;0
43;2020-S19;A;2;0;0;0;2;0
43;2020-S19;B;31;0;14;0;17;0
43;2020-S19;C;32;0;12;0;19;0
43;2020-S19;D;19;0;8;0;11;0
43;2020-S19;E;33;0;12;0;21;0
43;2020-S20;0;352;1;143;0;202;1
43;2020-S20;A;28;0;14;0;11;0
43;2020-S20;B;111;0;48;0;59;0
43;2020-S20;C;111;1;39;0;72;1
43;2020-S20;D;37;0;16;0;21;0
43;2020-S20;E;65;0;26;0;39;0
43;2020-S21;0;243;4;119;2;122;2
43;2020-S21;A;23;0;14;0;9;0
43;2020-S21;B;81;0;34;0;45;0
43;2020-S21;C;59;2;30;1;29;1
43;2020-S21;D;35;2;16;1;19;1
43;2020-S21;E;45;0;25;0;20;0
44;2020-S11;0;0;0;0;0;0;0
44;2020-S11;A;0;0;0;0;0;0
44;2020-S11;B;0;0;0;0;0;0
44;2020-S11;C;0;0;0;0;0;0
44;2020-S11;D;0;0;0;0;0;0
44;2020-S11;E;0;0;0;0;0;0
44;2020-S12;0;14;5;6;3;8;2
44;2020-S12;A;1;0;1;0;0;0
44;2020-S12;B;4;1;1;0;3;1
44;2020-S12;C;2;0;0;0;2;0
44;2020-S12;D;2;2;1;1;1;1
44;2020-S12;E;5;2;3;2;2;0
44;2020-S13;0;148;15;40;7;108;8
44;2020-S13;A;1;0;0;0;1;0
44;2020-S13;B;51;4;9;2;42;2
44;2020-S13;C;37;5;12;3;25;2
44;2020-S13;D;9;2;3;0;6;2
44;2020-S13;E;50;4;16;2;34;2
44;2020-S14;0;120;16;30;2;90;14
44;2020-S14;A;1;0;0;0;1;0
44;2020-S14;B;52;7;10;1;42;6
44;2020-S14;C;32;5;6;0;26;5
44;2020-S14;D;11;0;5;0;6;0
44;2020-S14;E;24;4;9;1;15;3
44;2020-S15;0;73;2;20;1;53;1
44;2020-S15;A;0;0;0;0;0;0
44;2020-S15;B;27;1;4;0;23;1
44;2020-S15;C;24;1;5;1;19;0
44;2020-S15;D;5;0;3;0;2;0
44;2020-S15;E;17;0;8;0;9;0
44;2020-S16;0;8;0;5;0;3;0
44;2020-S16;A;0;0;0;0;0;0
44;2020-S16;B;3;0;1;0;2;0
44;2020-S16;C;1;0;0;0;1;0
44;2020-S16;D;2;0;2;0;0;0
44;2020-S16;E;2;0;2;0;0;0
44;2020-S17;0;39;0;10;0;29;0
44;2020-S17;A;0;0;0;0;0;0
44;2020-S17;B;19;0;5;0;14;0
44;2020-S17;C;10;0;2;0;8;0
44;2020-S17;D;3;0;2;0;1;0
44;2020-S17;E;7;0;1;0;6;0
44;2020-S18;0;68;0;9;0;59;0
44;2020-S18;A;0;0;0;0;0;0
44;2020-S18;B;36;0;4;0;32;0
44;2020-S18;C;27;0;4;0;23;0
44;2020-S18;D;1;0;0;0;1;0
44;2020-S18;E;4;0;1;0;3;0
44;2020-S19;0;58;0;20;0;38;0
44;2020-S19;A;2;0;1;0;1;0
44;2020-S19;B;29;0;8;0;21;0
44;2020-S19;C;15;0;8;0;7;0
44;2020-S19;D;6;0;0;0;6;0
44;2020-S19;E;6;0;3;0;3;0
44;2020-S20;0;196;1;71;0;125;1
44;2020-S20;A;19;0;9;0;10;0
44;2020-S20;B;94;1;39;0;55;1
44;2020-S20;C;53;0;14;0;39;0
44;2020-S20;D;14;0;3;0;11;0
44;2020-S20;E;16;0;6;0;10;0
44;2020-S21;0;114;0;25;0;89;0
44;2020-S21;A;1;0;0;0;1;0
44;2020-S21;B;29;0;4;0;25;0
44;2020-S21;C;20;0;4;0;16;0
44;2020-S21;D;4;0;0;0;4;0
44;2020-S21;E;60;0;17;0;43;0
45;2020-S11;0;4;1;4;1;0;0
45;2020-S11;A;0;0;0;0;0;0
45;2020-S11;B;1;0;1;0;0;0
45;2020-S11;C;2;1;2;1;0;0
45;2020-S11;D;1;0;1;0;0;0
45;2020-S11;E;0;0;0;0;0;0
45;2020-S12;0;57;10;16;2;41;8
45;2020-S12;A;0;0;0;0;0;0
45;2020-S12;B;20;5;3;1;17;4
45;2020-S12;C;27;3;6;0;21;3
45;2020-S12;D;7;2;4;1;3;1
45;2020-S12;E;3;0;3;0;0;0
45;2020-S13;0;370;77;134;31;236;46
45;2020-S13;A;10;0;4;0;6;0
45;2020-S13;B;159;23;48;7;111;16
45;2020-S13;C;124;31;47;11;77;20
45;2020-S13;D;28;6;17;5;11;1
45;2020-S13;E;49;17;18;8;31;9
45;2020-S14;0;694;114;245;40;449;74
45;2020-S14;A;21;2;11;0;10;2
45;2020-S14;B;324;38;104;13;220;25
45;2020-S14;C;229;46;85;15;144;31
45;2020-S14;D;48;11;24;7;24;4
45;2020-S14;E;72;17;21;5;51;12
45;2020-S15;0;591;93;227;38;364;55
45;2020-S15;A;20;4;9;1;11;3
45;2020-S15;B;258;28;97;15;161;13
45;2020-S15;C;201;39;84;16;117;23
45;2020-S15;D;50;4;19;0;31;4
45;2020-S15;E;62;18;18;6;44;12
45;2020-S16;0;93;5;18;0;75;5
45;2020-S16;A;0;0;0;0;0;0
45;2020-S16;B;45;1;8;0;37;1
45;2020-S16;C;26;0;5;0;21;0
45;2020-S16;D;7;0;2;0;5;0
45;2020-S16;E;15;4;3;0;12;4
45;2020-S17;0;265;8;62;1;203;7
45;2020-S17;A;2;0;1;0;1;0
45;2020-S17;B;82;3;9;0;73;3
45;2020-S17;C;51;0;15;0;36;0
45;2020-S17;D;20;0;9;0;11;0
45;2020-S17;E;109;5;28;1;81;4
45;2020-S18;0;386;3;95;1;291;2
45;2020-S18;A;1;0;1;0;0;0
45;2020-S18;B;113;3;26;1;87;2
45;2020-S18;C;75;0;23;0;52;0
45;2020-S18;D;21;0;11;0;10;0
45;2020-S18;E;176;0;34;0;142;0
45;2020-S19;0;292;3;69;2;223;1
45;2020-S19;A;1;0;0;0;1;0
45;2020-S19;B;98;0;19;0;79;0
45;2020-S19;C;55;1;17;1;38;0
45;2020-S19;D;7;0;3;0;4;0
45;2020-S19;E;130;2;30;1;100;1
45;2020-S20;0;211;3;93;1;118;2
45;2020-S20;A;14;0;8;0;6;0
45;2020-S20;B;89;1;38;1;51;0
45;2020-S20;C;48;0;19;0;29;0
45;2020-S20;D;31;0;14;0;17;0
45;2020-S20;E;29;2;14;0;15;2
45;2020-S21;0;397;8;110;3;287;5
45;2020-S21;A;4;0;3;0;1;0
45;2020-S21;B;152;4;46;2;106;2
45;2020-S21;C;89;1;23;1;66;0
45;2020-S21;D;34;0;16;0;18;0
45;2020-S21;E;118;3;22;0;96;3
46;2020-S11;0;0;0;0;0;0;0
46;2020-S11;A;0;0;0;0;0;0
46;2020-S11;B;0;0;0;0;0;0
46;2020-S11;C;0;0;0;0;0;0
46;2020-S11;D;0;0;0;0;0;0
46;2020-S11;E;0;0;0;0;0;0
46;2020-S12;0;7;1;0;0;7;1
46;2020-S12;A;0;0;0;0;0;0
46;2020-S12;B;4;1;0;0;4;1
46;2020-S12;C;1;0;0;0;1;0
46;2020-S12;D;0;0;0;0;0;0
46;2020-S12;E;2;0;0;0;2;0
46;2020-S13;0;36;6;12;2;24;4
46;2020-S13;A;1;0;1;0;0;0
46;2020-S13;B;9;0;0;0;9;0
46;2020-S13;C;12;1;7;1;5;0
46;2020-S13;D;6;1;3;0;3;1
46;2020-S13;E;8;4;1;1;7;3
46;2020-S14;0;59;6;21;2;38;4
46;2020-S14;A;1;0;0;0;1;0
46;2020-S14;B;19;0;3;0;16;0
46;2020-S14;C;18;3;8;1;10;2
46;2020-S14;D;6;0;3;0;3;0
46;2020-S14;E;14;3;7;1;7;2
46;2020-S15;0;48;4;18;1;30;3
46;2020-S15;A;0;0;0;0;0;0
46;2020-S15;B;15;1;5;0;10;1
46;2020-S15;C;17;1;7;1;10;0
46;2020-S15;D;6;1;2;0;4;1
46;2020-S15;E;8;1;3;0;5;1
46;2020-S16;0;27;2;6;0;21;2
46;2020-S16;A;1;0;1;0;0;0
46;2020-S16;B;8;0;2;0;6;0
46;2020-S16;C;7;1;1;0;6;1
46;2020-S16;D;6;1;1;0;5;1
46;2020-S16;E;5;0;1;0;4;0
46;2020-S17;0;35;0;10;0;25;0
46;2020-S17;A;1;0;1;0;0;0
46;2020-S17;B;18;0;5;0;13;0
46;2020-S17;C;14;0;2;0;12;0
46;2020-S17;D;1;0;1;0;0;0
46;2020-S17;E;1;0;1;0;0;0
46;2020-S18;0;60;0;14;0;46;0
46;2020-S18;A;0;0;0;0;0;0
46;2020-S18;B;26;0;5;0;21;0
46;2020-S18;C;25;0;4;0;21;0
46;2020-S18;D;3;0;2;0;1;0
46;2020-S18;E;6;0;3;0;3;0
46;2020-S19;0;70;0;14;0;56;0
46;2020-S19;A;2;0;0;0;2;0
46;2020-S19;B;21;0;2;0;19;0
46;2020-S19;C;29;0;3;0;26;0
46;2020-S19;D;5;0;1;0;4;0
46;2020-S19;E;13;0;8;0;5;0
46;2020-S20;0;107;0;31;0;76;0
46;2020-S20;A;2;0;2;0;0;0
46;2020-S20;B;39;0;10;0;29;0
46;2020-S20;C;40;0;10;0;30;0
46;2020-S20;D;10;0;6;0;4;0
46;2020-S20;E;16;0;3;0;13;0
46;2020-S21;0;107;0;31;0;76;0
46;2020-S21;A;8;0;2;0;6;0
46;2020-S21;B;44;0;11;0;33;0
46;2020-S21;C;30;0;7;0;23;0
46;2020-S21;D;12;0;7;0;5;0
46;2020-S21;E;13;0;4;0;9;0
47;2020-S11;0;9;0;6;0;3;0
47;2020-S11;A;1;0;1;0;0;0
47;2020-S11;B;3;0;3;0;0;0
47;2020-S11;C;3;0;1;0;2;0
47;2020-S11;D;1;0;0;0;1;0
47;2020-S11;E;1;0;1;0;0;0
47;2020-S12;0;20;0;9;0;11;0
47;2020-S12;A;0;0;0;0;0;0
47;2020-S12;B;12;0;5;0;7;0
47;2020-S12;C;6;0;3;0;3;0
47;2020-S12;D;1;0;1;0;0;0
47;2020-S12;E;1;0;0;0;1;0
47;2020-S13;0;58;3;18;1;40;2
47;2020-S13;A;1;0;1;0;0;0
47;2020-S13;B;29;3;4;1;25;2
47;2020-S13;C;12;0;5;0;7;0
47;2020-S13;D;2;0;1;0;1;0
47;2020-S13;E;14;0;7;0;7;0
47;2020-S14;0;99;5;23;2;76;3
47;2020-S14;A;1;0;0;0;1;0
47;2020-S14;B;50;3;10;0;40;3
47;2020-S14;C;36;1;7;1;29;0
47;2020-S14;D;5;1;3;1;2;0
47;2020-S14;E;7;0;3;0;4;0
47;2020-S15;0;83;3;34;2;49;1
47;2020-S15;A;0;0;0;0;0;0
47;2020-S15;B;32;0;11;0;21;0
47;2020-S15;C;24;2;9;1;15;1
47;2020-S15;D;9;0;6;0;3;0
47;2020-S15;E;15;1;7;1;8;0
47;2020-S16;0;66;2;19;1;47;1
47;2020-S16;A;1;0;1;0;0;0
47;2020-S16;B;27;0;7;0;20;0
47;2020-S16;C;23;2;6;1;17;1
47;2020-S16;D;6;0;4;0;2;0
47;2020-S16;E;7;0;1;0;6;0
47;2020-S17;0;74;0;16;0;58;0
47;2020-S17;A;0;0;0;0;0;0
47;2020-S17;B;9;0;3;0;6;0
47;2020-S17;C;8;0;3;0;5;0
47;2020-S17;D;3;0;2;0;1;0
47;2020-S17;E;54;0;8;0;46;0
47;2020-S18;0;117;1;52;0;65;1
47;2020-S18;A;1;0;0;0;1;0
47;2020-S18;B;37;0;19;0;18;0
47;2020-S18;C;30;0;12;0;18;0
47;2020-S18;D;10;0;7;0;3;0
47;2020-S18;E;39;1;14;0;25;1
47;2020-S19;0;161;1;43;0;118;1
47;2020-S19;A;4;0;2;0;2;0
47;2020-S19;B;36;0;7;0;29;0
47;2020-S19;C;33;0;14;0;19;0
47;2020-S19;D;9;0;3;0;6;0
47;2020-S19;E;79;1;17;0;62;1
47;2020-S20;0;245;1;95;0;150;1
47;2020-S20;A;21;0;13;0;8;0
47;2020-S20;B;94;0;33;0;61;0
47;2020-S20;C;71;1;20;0;51;1
47;2020-S20;D;21;0;12;0;9;0
47;2020-S20;E;35;0;16;0;19;0
47;2020-S21;0;146;0;58;0;88;0
47;2020-S21;A;15;0;12;0;3;0
47;2020-S21;B;44;0;21;0;23;0
47;2020-S21;C;44;0;14;0;30;0
47;2020-S21;D;17;0;6;0;11;0
47;2020-S21;E;26;0;5;0;21;0
48;2020-S11;0;0;0;0;0;0;0
48;2020-S11;A;0;0;0;0;0;0
48;2020-S11;B;0;0;0;0;0;0
48;2020-S11;C;0;0;0;0;0;0
48;2020-S11;D;0;0;0;0;0;0
48;2020-S11;E;0;0;0;0;0;0
48;2020-S12;0;4;1;1;1;3;0
48;2020-S12;A;0;0;0;0;0;0
48;2020-S12;B;1;0;0;0;1;0
48;2020-S12;C;1;1;1;1;0;0
48;2020-S12;D;0;0;0;0;0;0
48;2020-S12;E;2;0;0;0;2;0
48;2020-S13;0;12;0;5;0;7;0
48;2020-S13;A;0;0;0;0;0;0
48;2020-S13;B;3;0;0;0;3;0
48;2020-S13;C;2;0;1;0;1;0
48;2020-S13;D;3;0;3;0;0;0
48;2020-S13;E;4;0;1;0;3;0
48;2020-S14;0;11;1;5;1;6;0
48;2020-S14;A;0;0;0;0;0;0
48;2020-S14;B;3;0;0;0;3;0
48;2020-S14;C;4;0;3;0;1;0
48;2020-S14;D;3;1;2;1;1;0
48;2020-S14;E;1;0;0;0;1;0
48;2020-S15;0;6;0;3;0;3;0
48;2020-S15;A;0;0;0;0;0;0
48;2020-S15;B;1;0;1;0;0;0
48;2020-S15;C;5;0;2;0;3;0
48;2020-S15;D;0;0;0;0;0;0
48;2020-S15;E;0;0;0;0;0;0
48;2020-S16;0;11;0;4;0;7;0
48;2020-S16;A;1;0;1;0;0;0
48;2020-S16;B;2;0;0;0;2;0
48;2020-S16;C;3;0;1;0;2;0
48;2020-S16;D;3;0;2;0;1;0
48;2020-S16;E;2;0;0;0;2;0
48;2020-S17;0;15;0;8;0;7;0
48;2020-S17;A;0;0;0;0;0;0
48;2020-S17;B;4;0;2;0;2;0
48;2020-S17;C;4;0;2;0;2;0
48;2020-S17;D;3;0;3;0;0;0
48;2020-S17;E;4;0;1;0;3;0
48;2020-S18;0;17;1;7;1;10;0
48;2020-S18;A;2;0;2;0;0;0
48;2020-S18;B;5;0;3;0;2;0
48;2020-S18;C;5;0;0;0;5;0
48;2020-S18;D;3;0;1;0;2;0
48;2020-S18;E;2;1;1;1;1;0
48;2020-S19;0;306;1;89;1;216;0
48;2020-S19;A;7;0;5;0;2;0
48;2020-S19;B;40;0;11;0;29;0
48;2020-S19;C;45;0;14;0;31;0
48;2020-S19;D;25;0;10;0;15;0
48;2020-S19;E;189;1;49;1;139;0
48;2020-S20;0;94;0;34;0;59;0
48;2020-S20;A;4;0;0;0;3;0
48;2020-S20;B;32;0;12;0;20;0
48;2020-S20;C;28;0;7;0;21;0
48;2020-S20;D;16;0;9;0;7;0
48;2020-S20;E;14;0;6;0;8;0
48;2020-S21;0;112;0;41;0;71;0
48;2020-S21;A;3;0;2;0;1;0
48;2020-S21;B;40;0;12;0;28;0
48;2020-S21;C;36;0;12;0;24;0
48;2020-S21;D;16;0;7;0;9;0
48;2020-S21;E;17;0;8;0;9;0
49;2020-S11;0;0;0;0;0;0;0
49;2020-S11;A;0;0;0;0;0;0
49;2020-S11;B;0;0;0;0;0;0
49;2020-S11;C;0;0;0;0;0;0
49;2020-S11;D;0;0;0;0;0;0
49;2020-S11;E;0;0;0;0;0;0
49;2020-S12;0;12;4;4;2;8;2
49;2020-S12;A;0;0;0;0;0;0
49;2020-S12;B;3;2;1;1;2;1
49;2020-S12;C;5;0;2;0;3;0
49;2020-S12;D;1;1;0;0;1;1
49;2020-S12;E;3;1;1;1;2;0
49;2020-S13;0;25;1;12;0;13;1
49;2020-S13;A;1;0;1;0;0;0
49;2020-S13;B;4;1;1;0;3;1
49;2020-S13;C;4;0;1;0;3;0
49;2020-S13;D;5;0;4;0;1;0
49;2020-S13;E;11;0;5;0;6;0
49;2020-S14;0;16;2;6;0;10;2
49;2020-S14;A;0;0;0;0;0;0
49;2020-S14;B;6;1;2;0;4;1
49;2020-S14;C;1;0;1;0;0;0
49;2020-S14;D;3;0;2;0;1;0
49;2020-S14;E;6;1;1;0;5;1
49;2020-S15;0;6;1;0;0;6;1
49;2020-S15;A;0;0;0;0;0;0
49;2020-S15;B;5;1;0;0;5;1
49;2020-S15;C;0;0;0;0;0;0
49;2020-S15;D;0;0;0;0;0;0
49;2020-S15;E;1;0;0;0;1;0
49;2020-S16;0;6;1;2;1;4;0
49;2020-S16;A;0;0;0;0;0;0
49;2020-S16;B;1;0;0;0;1;0
49;2020-S16;C;0;0;0;0;0;0
49;2020-S16;D;0;0;0;0;0;0
49;2020-S16;E;5;1;2;1;3;0
49;2020-S17;0;35;3;8;3;27;0
49;2020-S17;A;0;0;0;0;0;0
49;2020-S17;B;6;0;0;0;6;0
49;2020-S17;C;1;0;0;0;1;0
49;2020-S17;D;2;0;0;0;2;0
49;2020-S17;E;26;3;8;3;18;0
49;2020-S18;0;18;1;7;1;11;0
49;2020-S18;A;0;0;0;0;0;0
49;2020-S18;B;8;0;2;0;6;0
49;2020-S18;C;5;1;3;1;2;0
49;2020-S18;D;2;0;1;0;1;0
49;2020-S18;E;3;0;1;0;2;0
49;2020-S19;0;13;0;7;0;6;0
49;2020-S19;A;1;0;1;0;0;0
49;2020-S19;B;3;0;2;0;1;0
49;2020-S19;C;8;0;4;0;4;0
49;2020-S19;D;1;0;0;0;1;0
49;2020-S19;E;0;0;0;0;0;0
49;2020-S20;0;8;0;4;0;4;0
49;2020-S20;A;0;0;0;0;0;0
49;2020-S20;B;4;0;2;0;2;0
49;2020-S20;C;2;0;1;0;1;0
49;2020-S20;D;0;0;0;0;0;0
49;2020-S20;E;2;0;1;0;1;0
49;2020-S21;0;4;0;2;0;2;0
49;2020-S21;A;1;0;1;0;0;0
49;2020-S21;B;1;0;0;0;1;0
49;2020-S21;C;2;0;1;0;1;0
49;2020-S21;D;0;0;0;0;0;0
49;2020-S21;E;0;0;0;0;0;0
50;2020-S11;0;4;0;1;0;3;0
50;2020-S11;A;0;0;0;0;0;0
50;2020-S11;B;1;0;0;0;1;0
50;2020-S11;C;3;0;1;0;2;0
50;2020-S11;D;0;0;0;0;0;0
50;2020-S11;E;0;0;0;0;0;0
50;2020-S12;0;21;4;7;2;14;2
50;2020-S12;A;1;0;0;0;1;0
50;2020-S12;B;7;1;1;0;6;1
50;2020-S12;C;4;1;2;1;2;0
50;2020-S12;D;3;1;2;1;1;0
50;2020-S12;E;6;1;2;0;4;1
50;2020-S13;0;169;24;59;11;110;13
50;2020-S13;A;0;0;0;0;0;0
50;2020-S13;B;58;7;17;1;41;6
50;2020-S13;C;64;9;22;6;42;3
50;2020-S13;D;23;6;11;3;12;3
50;2020-S13;E;24;2;9;1;15;1
50;2020-S14;0;241;23;99;11;142;12
50;2020-S14;A;2;0;1;0;1;0
50;2020-S14;B;105;4;38;1;67;3
50;2020-S14;C;81;7;34;3;47;4
50;2020-S14;D;24;5;15;3;9;2
50;2020-S14;E;28;7;11;4;17;3
50;2020-S15;0;350;30;129;7;221;23
50;2020-S15;A;9;0;3;0;6;0
50;2020-S15;B;117;9;43;2;74;7
50;2020-S15;C;133;12;56;4;77;8
50;2020-S15;D;41;5;16;1;25;4
50;2020-S15;E;50;4;11;0;39;4
50;2020-S16;0;356;33;149;12;207;21
50;2020-S16;A;9;0;4;0;5;0
50;2020-S16;B;143;10;68;5;75;5
50;2020-S16;C;128;11;45;6;83;5
50;2020-S16;D;42;3;16;0;26;3
50;2020-S16;E;33;9;16;1;17;8
50;2020-S17;0;151;2;73;1;78;1
50;2020-S17;A;4;0;2;0;2;0
50;2020-S17;B;68;0;35;0;33;0
50;2020-S17;C;39;0;20;0;19;0
50;2020-S17;D;19;1;9;1;10;0
50;2020-S17;E;21;1;7;0;14;1
50;2020-S18;0;223;2;72;1;151;1
50;2020-S18;A;1;0;0;0;1;0
50;2020-S18;B;80;1;25;1;55;0
50;2020-S18;C;48;1;19;0;29;1
50;2020-S18;D;19;0;11;0;8;0
50;2020-S18;E;75;0;17;0;58;0
50;2020-S19;0;203;2;73;1;130;1
50;2020-S19;A;8;0;3;0;5;0
50;2020-S19;B;86;1;35;1;51;0
50;2020-S19;C;29;0;11;0;18;0
50;2020-S19;D;15;1;3;0;12;1
50;2020-S19;E;65;0;21;0;44;0
50;2020-S20;0;15;0;3;0;12;0
50;2020-S20;A;0;0;0;0;0;0
50;2020-S20;B;7;0;0;0;7;0
50;2020-S20;C;4;0;2;0;2;0
50;2020-S20;D;0;0;0;0;0;0
50;2020-S20;E;4;0;1;0;3;0
50;2020-S21;0;1;0;0;0;1;0
50;2020-S21;A;0;0;0;0;0;0
50;2020-S21;B;0;0;0;0;0;0
50;2020-S21;C;1;0;0;0;1;0
50;2020-S21;D;0;0;0;0;0;0
50;2020-S21;E;0;0;0;0;0;0
51;2020-S11;0;0;0;0;0;0;0
51;2020-S11;A;0;0;0;0;0;0
51;2020-S11;B;0;0;0;0;0;0
51;2020-S11;C;0;0;0;0;0;0
51;2020-S11;D;0;0;0;0;0;0
51;2020-S11;E;0;0;0;0;0;0
51;2020-S12;0;36;6;15;4;21;2
51;2020-S12;A;0;0;0;0;0;0
51;2020-S12;B;19;2;7;1;12;1
51;2020-S12;C;14;4;6;3;8;1
51;2020-S12;D;0;0;0;0;0;0
51;2020-S12;E;3;0;2;0;1;0
51;2020-S13;0;246;78;80;28;166;50
51;2020-S13;A;0;0;0;0;0;0
51;2020-S13;B;116;32;35;10;81;22
51;2020-S13;C;77;22;29;8;48;14
51;2020-S13;D;17;6;7;2;10;4
51;2020-S13;E;34;17;9;8;25;9
51;2020-S14;0;407;104;118;29;289;75
51;2020-S14;A;2;0;1;0;1;0
51;2020-S14;B;178;40;39;6;139;34
51;2020-S14;C;141;36;37;10;104;26
51;2020-S14;D;44;16;25;9;19;7
51;2020-S14;E;41;12;15;4;26;8
51;2020-S15;0;355;71;123;19;232;52
51;2020-S15;A;0;0;0;0;0;0
51;2020-S15;B;136;20;49;4;87;16
51;2020-S15;C;112;29;39;7;73;22
51;2020-S15;D;29;3;11;3;18;0
51;2020-S15;E;77;19;24;5;53;14
51;2020-S16;0;435;75;125;14;310;61
51;2020-S16;A;0;0;0;0;0;0
51;2020-S16;B;131;18;24;2;107;16
51;2020-S16;C;109;18;43;6;66;12
51;2020-S16;D;45;5;21;2;24;3
51;2020-S16;E;149;34;37;4;112;30
51;2020-S17;0;179;14;54;5;125;9
51;2020-S17;A;2;0;1;0;1;0
51;2020-S17;B;48;6;17;1;31;5
51;2020-S17;C;33;2;10;1;23;1
51;2020-S17;D;16;2;8;1;8;1
51;2020-S17;E;80;4;18;2;62;2
51;2020-S18;0;34;2;7;0;27;2
51;2020-S18;A;0;0;0;0;0;0
51;2020-S18;B;13;0;4;0;9;0
51;2020-S18;C;14;0;2;0;12;0
51;2020-S18;D;4;1;0;0;4;1
51;2020-S18;E;3;1;1;0;2;1
51;2020-S19;0;33;1;8;0;25;1
51;2020-S19;A;1;0;1;0;0;0
51;2020-S19;B;11;0;1;0;10;0
51;2020-S19;C;15;1;2;0;13;1
51;2020-S19;D;3;0;2;0;1;0
51;2020-S19;E;3;0;2;0;1;0
51;2020-S20;0;15;1;4;0;11;1
51;2020-S20;A;0;0;0;0;0;0
51;2020-S20;B;5;0;2;0;3;0
51;2020-S20;C;5;0;1;0;4;0
51;2020-S20;D;1;0;0;0;1;0
51;2020-S20;E;4;1;1;0;3;1
51;2020-S21;0;8;0;5;0;3;0
51;2020-S21;A;0;0;0;0;0;0
51;2020-S21;B;2;0;2;0;0;0
51;2020-S21;C;2;0;1;0;1;0
51;2020-S21;D;1;0;1;0;0;0
51;2020-S21;E;3;0;1;0;2;0
52;2020-S11;0;0;0;0;0;0;0
52;2020-S11;A;0;0;0;0;0;0
52;2020-S11;B;0;0;0;0;0;0
52;2020-S11;C;0;0;0;0;0;0
52;2020-S11;D;0;0;0;0;0;0
52;2020-S11;E;0;0;0;0;0;0
52;2020-S12;0;20;3;5;1;15;2
52;2020-S12;A;0;0;0;0;0;0
52;2020-S12;B;6;0;0;0;6;0
52;2020-S12;C;7;1;2;0;5;1
52;2020-S12;D;0;0;0;0;0;0
52;2020-S12;E;7;2;3;1;4;1
52;2020-S13;0;42;11;8;3;34;8
52;2020-S13;A;1;0;0;0;1;0
52;2020-S13;B;13;2;0;0;13;2
52;2020-S13;C;14;4;2;1;12;3
52;2020-S13;D;2;0;1;0;1;0
52;2020-S13;E;12;5;5;2;7;3
52;2020-S14;0;27;10;8;4;19;6
52;2020-S14;A;0;0;0;0;0;0
52;2020-S14;B;5;1;1;0;4;1
52;2020-S14;C;13;5;2;1;11;4
52;2020-S14;D;1;1;0;0;1;1
52;2020-S14;E;8;3;5;3;3;0
52;2020-S15;0;23;5;7;0;16;5
52;2020-S15;A;0;0;0;0;0;0
52;2020-S15;B;10;2;3;0;7;2
52;2020-S15;C;9;2;3;0;6;2
52;2020-S15;D;1;1;0;0;1;1
52;2020-S15;E;3;0;1;0;2;0
52;2020-S16;0;14;3;3;1;11;2
52;2020-S16;A;0;0;0;0;0;0
52;2020-S16;B;0;0;0;0;0;0
52;2020-S16;C;10;1;1;0;9;1
52;2020-S16;D;1;0;0;0;1;0
52;2020-S16;E;3;2;2;1;1;1
52;2020-S17;0;21;4;7;3;14;1
52;2020-S17;A;0;0;0;0;0;0
52;2020-S17;B;5;1;2;1;3;0
52;2020-S17;C;5;2;1;1;4;1
52;2020-S17;D;1;0;0;0;1;0
52;2020-S17;E;10;1;4;1;6;0
52;2020-S18;0;24;1;2;0;22;1
52;2020-S18;A;1;0;0;0;1;0
52;2020-S18;B;19;0;2;0;17;0
52;2020-S18;C;2;0;0;0;2;0
52;2020-S18;D;1;1;0;0;1;1
52;2020-S18;E;1;0;0;0;1;0
52;2020-S19;0;13;0;3;0;10;0
52;2020-S19;A;0;0;0;0;0;0
52;2020-S19;B;6;0;0;0;6;0
52;2020-S19;C;6;0;2;0;4;0
52;2020-S19;D;0;0;0;0;0;0
52;2020-S19;E;1;0;1;0;0;0
52;2020-S20;0;7;0;1;0;6;0
52;2020-S20;A;0;0;0;0;0;0
52;2020-S20;B;3;0;0;0;3;0
52;2020-S20;C;3;0;1;0;2;0
52;2020-S20;D;0;0;0;0;0;0
52;2020-S20;E;1;0;0;0;1;0
52;2020-S21;0;8;0;3;0;5;0
52;2020-S21;A;2;0;1;0;1;0
52;2020-S21;B;1;0;1;0;0;0
52;2020-S21;C;2;0;1;0;1;0
52;2020-S21;D;2;0;0;0;2;0
52;2020-S21;E;1;0;0;0;1;0
53;2020-S11;0;0;0;0;0;0;0
53;2020-S11;A;0;0;0;0;0;0
53;2020-S11;B;0;0;0;0;0;0
53;2020-S11;C;0;0;0;0;0;0
53;2020-S11;D;0;0;0;0;0;0
53;2020-S11;E;0;0;0;0;0;0
53;2020-S12;0;3;0;2;0;1;0
53;2020-S12;A;0;0;0;0;0;0
53;2020-S12;B;3;0;2;0;1;0
53;2020-S12;C;0;0;0;0;0;0
53;2020-S12;D;0;0;0;0;0;0
53;2020-S12;E;0;0;0;0;0;0
53;2020-S13;0;4;0;0;0;4;0
53;2020-S13;A;0;0;0;0;0;0
53;2020-S13;B;1;0;0;0;1;0
53;2020-S13;C;0;0;0;0;0;0
53;2020-S13;D;1;0;0;0;1;0
53;2020-S13;E;2;0;0;0;2;0
53;2020-S14;0;2;1;0;0;2;1
53;2020-S14;A;0;0;0;0;0;0
53;2020-S14;B;2;1;0;0;2;1
53;2020-S14;C;0;0;0;0;0;0
53;2020-S14;D;0;0;0;0;0;0
53;2020-S14;E;0;0;0;0;0;0
53;2020-S15;0;14;2;3;0;11;2
53;2020-S15;A;0;0;0;0;0;0
53;2020-S15;B;6;1;2;0;4;1
53;2020-S15;C;7;1;0;0;7;1
53;2020-S15;D;0;0;0;0;0;0
53;2020-S15;E;1;0;1;0;0;0
53;2020-S16;0;18;2;4;0;14;2
53;2020-S16;A;0;0;0;0;0;0
53;2020-S16;B;6;0;1;0;5;0
53;2020-S16;C;7;2;0;0;7;2
53;2020-S16;D;2;0;1;0;1;0
53;2020-S16;E;3;0;2;0;1;0
53;2020-S17;0;185;3;29;1;156;2
53;2020-S17;A;1;0;1;0;0;0
53;2020-S17;B;98;3;16;1;82;2
53;2020-S17;C;78;0;11;0;67;0
53;2020-S17;D;6;0;0;0;6;0
53;2020-S17;E;2;0;1;0;1;0
53;2020-S18;0;63;2;9;0;54;2
53;2020-S18;A;1;0;0;0;1;0
53;2020-S18;B;30;1;4;0;26;1
53;2020-S18;C;27;1;3;0;24;1
53;2020-S18;D;4;0;2;0;2;0
53;2020-S18;E;1;0;0;0;1;0
53;2020-S19;0;72;3;20;1;52;2
53;2020-S19;A;3;0;2;0;1;0
53;2020-S19;B;40;2;8;1;32;1
53;2020-S19;C;24;0;7;0;17;0
53;2020-S19;D;3;0;2;0;1;0
53;2020-S19;E;2;1;1;0;1;1
53;2020-S20;0;87;1;33;0;54;1
53;2020-S20;A;9;0;5;0;4;0
53;2020-S20;B;35;1;13;0;22;1
53;2020-S20;C;30;0;11;0;19;0
53;2020-S20;D;8;0;3;0;5;0
53;2020-S20;E;5;0;1;0;4;0
53;2020-S21;0;52;0;25;0;27;0
53;2020-S21;A;7;0;3;0;4;0
53;2020-S21;B;18;0;8;0;10;0
53;2020-S21;C;19;0;11;0;8;0
53;2020-S21;D;5;0;3;0;2;0
53;2020-S21;E;3;0;0;0;3;0
54;2020-S11;0;0;0;0;0;0;0
54;2020-S11;A;0;0;0;0;0;0
54;2020-S11;B;0;0;0;0;0;0
54;2020-S11;C;0;0;0;0;0;0
54;2020-S11;D;0;0;0;0;0;0
54;2020-S11;E;0;0;0;0;0;0
54;2020-S12;0;21;9;10;5;11;4
54;2020-S12;A;1;0;1;0;0;0
54;2020-S12;B;6;2;1;0;5;2
54;2020-S12;C;9;4;6;3;3;1
54;2020-S12;D;3;2;1;1;2;1
54;2020-S12;E;2;1;1;1;1;0
54;2020-S13;0;228;41;71;18;157;23
54;2020-S13;A;5;0;2;0;3;0
54;2020-S13;B;96;9;22;1;74;8
54;2020-S13;C;65;13;21;7;44;6
54;2020-S13;D;29;13;15;7;14;6
54;2020-S13;E;30;6;9;3;21;3
54;2020-S14;0;351;49;111;19;240;30
54;2020-S14;A;1;0;0;0;1;0
54;2020-S14;B;140;18;42;6;98;12
54;2020-S14;C;154;19;48;6;106;13
54;2020-S14;D;29;4;12;4;17;0
54;2020-S14;E;23;7;9;3;14;4
54;2020-S15;0;426;47;119;17;307;30
54;2020-S15;A;6;0;2;0;4;0
54;2020-S15;B;144;9;40;3;104;6
54;2020-S15;C;125;9;30;4;95;5
54;2020-S15;D;31;7;17;4;14;3
54;2020-S15;E;120;22;30;6;90;16
54;2020-S16;0;430;24;125;10;305;14
54;2020-S16;A;4;0;2;0;2;0
54;2020-S16;B;120;6;34;3;86;3
54;2020-S16;C;104;9;34;3;70;6
54;2020-S16;D;36;4;17;2;19;2
54;2020-S16;E;165;5;37;2;128;3
54;2020-S17;0;527;12;152;5;375;7
54;2020-S17;A;2;0;1;0;1;0
54;2020-S17;B;163;3;45;1;118;2
54;2020-S17;C;87;4;28;1;59;3
54;2020-S17;D;41;1;22;1;19;0
54;2020-S17;E;232;4;56;2;176;2
54;2020-S18;0;41;1;15;1;26;0
54;2020-S18;A;1;0;0;0;1;0
54;2020-S18;B;14;1;7;1;7;0
54;2020-S18;C;8;0;2;0;6;0
54;2020-S18;D;7;0;3;0;4;0
54;2020-S18;E;11;0;3;0;8;0
54;2020-S19;0;81;1;42;0;39;1
54;2020-S19;A;0;0;0;0;0;0
54;2020-S19;B;32;1;13;0;19;1
54;2020-S19;C;29;0;16;0;13;0
54;2020-S19;D;8;0;6;0;2;0
54;2020-S19;E;12;0;7;0;5;0
54;2020-S20;0;151;1;59;0;92;1
54;2020-S20;A;2;0;1;0;1;0
54;2020-S20;B;67;0;22;0;45;0
54;2020-S20;C;43;0;16;0;27;0
54;2020-S20;D;18;0;11;0;7;0
54;2020-S20;E;20;1;8;0;12;1
54;2020-S21;0;48;1;19;0;29;1
54;2020-S21;A;1;0;1;0;0;0
54;2020-S21;B;20;0;10;0;10;0
54;2020-S21;C;17;0;4;0;13;0
54;2020-S21;D;2;0;0;0;2;0
54;2020-S21;E;8;1;4;0;4;1
55;2020-S11;0;0;0;0;0;0;0
55;2020-S11;A;0;0;0;0;0;0
55;2020-S11;B;0;0;0;0;0;0
55;2020-S11;C;0;0;0;0;0;0
55;2020-S11;D;0;0;0;0;0;0
55;2020-S11;E;0;0;0;0;0;0
55;2020-S12;0;3;1;0;0;3;1
55;2020-S12;A;0;0;0;0;0;0
55;2020-S12;B;2;1;0;0;2;1
55;2020-S12;C;0;0;0;0;0;0
55;2020-S12;D;1;0;0;0;1;0
55;2020-S12;E;0;0;0;0;0;0
55;2020-S13;0;33;10;8;2;25;8
55;2020-S13;A;0;0;0;0;0;0
55;2020-S13;B;15;1;2;0;13;1
55;2020-S13;C;16;8;5;2;11;6
55;2020-S13;D;1;0;1;0;0;0
55;2020-S13;E;1;1;0;0;1;1
55;2020-S14;0;94;20;26;5;68;15
55;2020-S14;A;1;0;1;0;0;0
55;2020-S14;B;44;6;9;1;35;5
55;2020-S14;C;26;5;9;2;17;3
55;2020-S14;D;7;3;2;2;5;1
55;2020-S14;E;16;6;5;0;11;6
55;2020-S15;0;134;16;27;2;107;14
55;2020-S15;A;2;0;1;0;1;0
55;2020-S15;B;26;2;5;0;21;2
55;2020-S15;C;35;7;6;1;29;6
55;2020-S15;D;12;0;5;0;7;0
55;2020-S15;E;59;7;10;1;49;6
55;2020-S16;0;136;11;31;0;105;11
55;2020-S16;A;2;0;1;0;1;0
55;2020-S16;B;46;3;9;0;37;3
55;2020-S16;C;37;4;4;0;33;4
55;2020-S16;D;12;1;6;0;6;1
55;2020-S16;E;39;3;11;0;28;3
55;2020-S17;0;240;14;50;1;190;13
55;2020-S17;A;1;0;0;0;1;0
55;2020-S17;B;64;3;7;0;57;3
55;2020-S17;C;51;2;12;0;39;2
55;2020-S17;D;22;2;9;1;13;1
55;2020-S17;E;102;7;22;0;80;7
55;2020-S18;0;83;0;11;0;72;0
55;2020-S18;A;0;0;0;0;0;0
55;2020-S18;B;38;0;6;0;32;0
55;2020-S18;C;28;0;2;0;26;0
55;2020-S18;D;1;0;1;0;0;0
55;2020-S18;E;16;0;2;0;14;0
55;2020-S19;0;1;1;1;1;0;0
55;2020-S19;A;0;0;0;0;0;0
55;2020-S19;B;0;0;0;0;0;0
55;2020-S19;C;1;1;1;1;0;0
55;2020-S19;D;0;0;0;0;0;0
55;2020-S19;E;0;0;0;0;0;0
55;2020-S20;0;4;1;4;1;0;0
55;2020-S20;A;0;0;0;0;0;0
55;2020-S20;B;2;0;2;0;0;0
55;2020-S20;C;2;1;2;1;0;0
55;2020-S20;D;0;0;0;0;0;0
55;2020-S20;E;0;0;0;0;0;0
55;2020-S21;0;2;2;2;2;0;0
55;2020-S21;A;0;0;0;0;0;0
55;2020-S21;B;0;0;0;0;0;0
55;2020-S21;C;2;2;2;2;0;0
55;2020-S21;D;0;0;0;0;0;0
55;2020-S21;E;0;0;0;0;0;0
56;2020-S11;0;0;0;0;0;0;0
56;2020-S11;A;0;0;0;0;0;0
56;2020-S11;B;0;0;0;0;0;0
56;2020-S11;C;0;0;0;0;0;0
56;2020-S11;D;0;0;0;0;0;0
56;2020-S11;E;0;0;0;0;0;0
56;2020-S12;0;1;0;0;0;1;0
56;2020-S12;A;0;0;0;0;0;0
56;2020-S12;B;0;0;0;0;0;0
56;2020-S12;C;1;0;0;0;1;0
56;2020-S12;D;0;0;0;0;0;0
56;2020-S12;E;0;0;0;0;0;0
56;2020-S13;0;9;1;3;1;6;0
56;2020-S13;A;0;0;0;0;0;0
56;2020-S13;B;4;0;2;0;2;0
56;2020-S13;C;2;0;0;0;2;0
56;2020-S13;D;1;0;0;0;1;0
56;2020-S13;E;2;1;1;1;1;0
56;2020-S14;0;6;1;0;0;6;1
56;2020-S14;A;0;0;0;0;0;0
56;2020-S14;B;2;0;0;0;2;0
56;2020-S14;C;4;1;0;0;4;1
56;2020-S14;D;0;0;0;0;0;0
56;2020-S14;E;0;0;0;0;0;0
56;2020-S15;0;6;0;4;0;2;0
56;2020-S15;A;0;0;0;0;0;0
56;2020-S15;B;1;0;1;0;0;0
56;2020-S15;C;3;0;2;0;1;0
56;2020-S15;D;1;0;0;0;1;0
56;2020-S15;E;1;0;1;0;0;0
56;2020-S16;0;4;1;1;0;3;1
56;2020-S16;A;1;0;1;0;0;0
56;2020-S16;B;0;0;0;0;0;0
56;2020-S16;C;1;0;0;0;1;0
56;2020-S16;D;1;0;0;0;1;0
56;2020-S16;E;1;1;0;0;1;1
56;2020-S17;0;12;0;4;0;8;0
56;2020-S17;A;0;0;0;0;0;0
56;2020-S17;B;5;0;4;0;1;0
56;2020-S17;C;5;0;0;0;5;0
56;2020-S17;D;1;0;0;0;1;0
56;2020-S17;E;1;0;0;0;1;0
56;2020-S18;0;1;0;0;0;1;0
56;2020-S18;A;0;0;0;0;0;0
56;2020-S18;B;0;0;0;0;0;0
56;2020-S18;C;1;0;0;0;1;0
56;2020-S18;D;0;0;0;0;0;0
56;2020-S18;E;0;0;0;0;0;0
56;2020-S19;0;2;0;0;0;2;0
56;2020-S19;A;0;0;0;0;0;0
56;2020-S19;B;2;0;0;0;2;0
56;2020-S19;C;0;0;0;0;0;0
56;2020-S19;D;0;0;0;0;0;0
56;2020-S19;E;0;0;0;0;0;0
56;2020-S20;0;3;0;0;0;3;0
56;2020-S20;A;0;0;0;0;0;0
56;2020-S20;B;2;0;0;0;2;0
56;2020-S20;C;0;0;0;0;0;0
56;2020-S20;D;1;0;0;0;1;0
56;2020-S20;E;0;0;0;0;0;0
56;2020-S21;0;3;0;3;0;0;0
56;2020-S21;A;0;0;0;0;0;0
56;2020-S21;B;2;0;2;0;0;0
56;2020-S21;C;1;0;1;0;0;0
56;2020-S21;D;0;0;0;0;0;0
56;2020-S21;E;0;0;0;0;0;0
57;2020-S11;0;25;3;9;2;16;1
57;2020-S11;A;2;0;0;0;2;0
57;2020-S11;B;9;1;3;0;6;1
57;2020-S11;C;9;0;3;0;6;0
57;2020-S11;D;3;2;2;2;1;0
57;2020-S11;E;2;0;1;0;1;0
57;2020-S12;0;39;17;18;8;21;9
57;2020-S12;A;0;0;0;0;0;0
57;2020-S12;B;8;2;1;0;7;2
57;2020-S12;C;16;8;11;5;5;3
57;2020-S12;D;6;2;3;1;3;1
57;2020-S12;E;9;5;3;2;6;3
57;2020-S13;0;251;76;64;16;187;60
57;2020-S13;A;1;0;0;0;1;0
57;2020-S13;B;104;30;18;4;86;26
57;2020-S13;C;97;28;28;8;69;20
57;2020-S13;D;15;3;6;1;9;2
57;2020-S13;E;34;15;12;3;22;12
57;2020-S14;0;629;186;206;68;423;118
57;2020-S14;A;4;0;4;0;0;0
57;2020-S14;B;246;57;66;17;180;40
57;2020-S14;C;227;65;70;26;157;39
57;2020-S14;D;54;20;31;10;23;10
57;2020-S14;E;98;44;35;15;63;29
57;2020-S15;0;867;182;254;51;613;131
57;2020-S15;A;4;0;2;0;2;0
57;2020-S15;B;218;30;55;7;163;23
57;2020-S15;C;214;26;73;12;141;14
57;2020-S15;D;73;20;40;8;33;12
57;2020-S15;E;358;106;84;24;274;82
57;2020-S16;0;934;135;238;28;696;107
57;2020-S16;A;5;0;1;0;4;0
57;2020-S16;B;258;28;61;3;197;25
57;2020-S16;C;240;22;70;5;170;17
57;2020-S16;D;54;9;28;7;26;2
57;2020-S16;E;377;76;78;13;299;63
57;2020-S17;0;725;54;217;9;508;45
57;2020-S17;A;9;0;4;0;5;0
57;2020-S17;B;180;15;54;3;126;12
57;2020-S17;C;172;10;52;2;120;8
57;2020-S17;D;59;2;28;0;31;2
57;2020-S17;E;305;27;79;4;226;23
57;2020-S18;0;131;11;38;6;93;5
57;2020-S18;A;3;2;1;1;2;1
57;2020-S18;B;15;0;2;0;13;0
57;2020-S18;C;14;1;4;1;10;0
57;2020-S18;D;15;0;7;0;8;0
57;2020-S18;E;84;8;24;4;60;4
57;2020-S19;0;6;0;5;0;1;0
57;2020-S19;A;0;0;0;0;0;0
57;2020-S19;B;2;0;2;0;0;0
57;2020-S19;C;2;0;2;0;0;0
57;2020-S19;D;1;0;1;0;0;0
57;2020-S19;E;1;0;0;0;1;0
57;2020-S20;0;35;0;15;0;20;0
57;2020-S20;A;0;0;0;0;0;0
57;2020-S20;B;15;0;7;0;8;0
57;2020-S20;C;14;0;5;0;9;0
57;2020-S20;D;4;0;1;0;3;0
57;2020-S20;E;2;0;2;0;0;0
57;2020-S21;0;67;0;31;0;36;0
57;2020-S21;A;5;0;1;0;4;0
57;2020-S21;B;30;0;16;0;14;0
57;2020-S21;C;15;0;5;0;10;0
57;2020-S21;D;8;0;5;0;3;0
57;2020-S21;E;9;0;4;0;5;0
58;2020-S11;0;5;0;1;0;4;0
58;2020-S11;A;0;0;0;0;0;0
58;2020-S11;B;2;0;1;0;1;0
58;2020-S11;C;2;0;0;0;2;0
58;2020-S11;D;0;0;0;0;0;0
58;2020-S11;E;1;0;0;0;1;0
58;2020-S12;0;20;1;5;1;15;0
58;2020-S12;A;0;0;0;0;0;0
58;2020-S12;B;11;1;4;1;7;0
58;2020-S12;C;7;0;1;0;6;0
58;2020-S12;D;1;0;0;0;1;0
58;2020-S12;E;1;0;0;0;1;0
58;2020-S13;0;80;14;28;2;52;12
58;2020-S13;A;2;0;1;0;1;0
58;2020-S13;B;43;6;15;1;28;5
58;2020-S13;C;21;3;6;0;15;3
58;2020-S13;D;9;2;3;0;6;2
58;2020-S13;E;5;3;3;1;2;2
58;2020-S14;0;224;32;78;9;146;23
58;2020-S14;A;3;0;2;0;1;0
58;2020-S14;B;83;8;26;0;57;8
58;2020-S14;C;95;15;29;5;66;10
58;2020-S14;D;17;2;11;2;6;0
58;2020-S14;E;25;7;10;2;15;5
58;2020-S15;0;264;56;81;16;183;40
58;2020-S15;A;1;0;0;0;1;0
58;2020-S15;B;78;7;21;2;57;5
58;2020-S15;C;82;13;27;3;55;10
58;2020-S15;D;24;2;11;1;13;1
58;2020-S15;E;78;34;22;10;56;24
58;2020-S16;0;376;28;99;9;277;19
58;2020-S16;A;2;0;2;0;0;0
58;2020-S16;B;123;6;26;3;97;3
58;2020-S16;C;153;13;39;4;114;9
58;2020-S16;D;20;1;7;0;13;1
58;2020-S16;E;77;8;25;2;52;6
58;2020-S17;0;349;13;96;4;253;9
58;2020-S17;A;3;1;1;0;2;1
58;2020-S17;B;86;6;25;2;61;4
58;2020-S17;C;71;3;20;0;51;3
58;2020-S17;D;15;0;5;0;10;0
58;2020-S17;E;135;3;40;2;95;1
58;2020-S18;0;206;10;52;4;154;6
58;2020-S18;A;1;0;1;0;0;0
58;2020-S18;B;81;2;18;1;63;1
58;2020-S18;C;70;1;11;0;59;1
58;2020-S18;D;17;1;10;1;7;0
58;2020-S18;E;35;6;12;2;23;4
58;2020-S19;0;399;1;123;0;276;1
58;2020-S19;A;6;0;2;0;4;0
58;2020-S19;B;77;1;21;0;56;1
58;2020-S19;C;83;0;33;0;50;0
58;2020-S19;D;25;0;14;0;11;0
58;2020-S19;E;207;0;52;0;155;0
58;2020-S20;0;281;9;136;2;145;7
58;2020-S20;A;5;0;2;0;3;0
58;2020-S20;B;126;2;72;0;54;2
58;2020-S20;C;89;1;41;0;48;1
58;2020-S20;D;26;0;11;0;15;0
58;2020-S20;E;34;6;10;2;24;4
58;2020-S21;0;263;1;86;0;177;1
58;2020-S21;A;6;1;3;0;3;1
58;2020-S21;B;99;0;22;0;77;0
58;2020-S21;C;100;0;32;0;68;0
58;2020-S21;D;30;0;18;0;12;0
58;2020-S21;E;28;0;11;0;17;0
59;2020-S11;0;3;1;2;1;1;0
59;2020-S11;A;0;0;0;0;0;0
59;2020-S11;B;1;0;0;0;1;0
59;2020-S11;C;2;1;2;1;0;0
59;2020-S11;D;0;0;0;0;0;0
59;2020-S11;E;0;0;0;0;0;0
59;2020-S12;0;52;7;24;6;28;1
59;2020-S12;A;1;0;1;0;0;0
59;2020-S12;B;9;0;2;0;7;0
59;2020-S12;C;10;1;8;1;2;0
59;2020-S12;D;7;1;4;1;3;0
59;2020-S12;E;24;5;8;4;16;1
59;2020-S13;0;249;70;97;34;152;36
59;2020-S13;A;0;0;0;0;0;0
59;2020-S13;B;80;19;17;4;63;15
59;2020-S13;C;59;20;27;10;32;10
59;2020-S13;D;27;10;17;9;10;1
59;2020-S13;E;83;21;36;11;47;10
59;2020-S14;0;387;77;128;26;259;51
59;2020-S14;A;4;0;3;0;1;0
59;2020-S14;B;155;29;40;11;115;18
59;2020-S14;C;131;20;54;7;77;13
59;2020-S14;D;32;4;19;2;13;2
59;2020-S14;E;65;24;12;6;53;18
59;2020-S15;0;633;117;206;30;427;87
59;2020-S15;A;9;0;3;0;6;0
59;2020-S15;B;287;45;84;5;203;40
59;2020-S15;C;201;40;75;14;126;26
59;2020-S15;D;51;9;19;3;32;6
59;2020-S15;E;83;23;24;8;59;15
59;2020-S16;0;380;61;130;13;250;48
59;2020-S16;A;5;1;2;0;3;1
59;2020-S16;B;191;33;65;5;126;28
59;2020-S16;C;121;17;44;6;77;11
59;2020-S16;D;27;2;11;0;16;2
59;2020-S16;E;36;8;8;2;28;6
59;2020-S17;0;633;54;210;16;423;38
59;2020-S17;A;11;0;8;0;3;0
59;2020-S17;B;291;28;85;7;206;21
59;2020-S17;C;243;23;79;8;164;15
59;2020-S17;D;47;2;24;1;23;1
59;2020-S17;E;41;1;14;0;27;1
59;2020-S18;0;731;47;266;12;465;35
59;2020-S18;A;6;0;5;0;1;0
59;2020-S18;B;273;17;96;3;177;14
59;2020-S18;C;200;9;72;2;128;7
59;2020-S18;D;71;3;35;2;36;1
59;2020-S18;E;179;18;57;5;122;13
59;2020-S19;0;579;40;212;18;367;22
59;2020-S19;A;13;0;7;0;6;0
59;2020-S19;B;221;17;82;7;139;10
59;2020-S19;C;182;14;63;4;119;10
59;2020-S19;D;51;4;29;4;22;0
59;2020-S19;E;112;5;31;3;81;2
59;2020-S20;0;1017;32;386;12;631;20
59;2020-S20;A;52;2;32;1;20;1
59;2020-S20;B;388;7;151;4;237;3
59;2020-S20;C;265;10;109;3;156;7
59;2020-S20;D;95;5;40;2;55;3
59;2020-S20;E;217;8;54;2;163;6
59;2020-S21;0;731;22;313;9;418;13
59;2020-S21;A;54;1;28;0;26;1
59;2020-S21;B;295;9;129;4;166;5
59;2020-S21;C;226;6;88;2;138;4
59;2020-S21;D;79;3;40;1;39;2
59;2020-S21;E;77;3;28;2;49;1
60;2020-S11;0;4;0;0;0;4;0
60;2020-S11;A;0;0;0;0;0;0
60;2020-S11;B;1;0;0;0;1;0
60;2020-S11;C;3;0;0;0;3;0
60;2020-S11;D;0;0;0;0;0;0
60;2020-S11;E;0;0;0;0;0;0
60;2020-S12;0;74;30;34;17;40;13
60;2020-S12;A;1;0;1;0;0;0
60;2020-S12;B;18;8;9;5;9;3
60;2020-S12;C;26;12;10;5;16;7
60;2020-S12;D;10;6;8;6;2;0
60;2020-S12;E;19;4;6;1;13;3
60;2020-S13;0;483;208;189;85;294;123
60;2020-S13;A;7;0;3;0;4;0
60;2020-S13;B;160;67;40;19;120;48
60;2020-S13;C;155;57;64;25;91;32
60;2020-S13;D;54;35;36;21;18;14
60;2020-S13;E;107;49;46;20;61;29
60;2020-S14;0;986;372;329;143;657;229
60;2020-S14;A;11;2;8;2;3;0
60;2020-S14;B;401;135;98;40;303;95
60;2020-S14;C;357;145;124;64;233;81
60;2020-S14;D;78;31;47;19;31;12
60;2020-S14;E;139;59;52;18;87;41
60;2020-S15;0;1013;285;345;93;668;192
60;2020-S15;A;7;0;5;0;2;0
60;2020-S15;B;394;91;102;22;292;69
60;2020-S15;C;309;89;126;39;183;50
60;2020-S15;D;83;17;36;6;47;11
60;2020-S15;E;219;88;76;26;143;62
60;2020-S16;0;629;108;226;31;403;77
60;2020-S16;A;5;0;3;0;2;0
60;2020-S16;B;242;45;88;13;154;32
60;2020-S16;C;199;42;71;11;128;31
60;2020-S16;D;52;8;21;7;31;1
60;2020-S16;E;131;13;43;0;88;13
60;2020-S17;0;948;96;293;33;655;63
60;2020-S17;A;8;0;5;0;3;0
60;2020-S17;B;343;27;88;3;255;24
60;2020-S17;C;292;29;107;16;185;13
60;2020-S17;D;63;8;31;4;32;4
60;2020-S17;E;240;32;62;10;178;22
60;2020-S18;0;987;63;282;16;705;47
60;2020-S18;A;9;0;4;0;5;0
60;2020-S18;B;348;18;98;3;250;15
60;2020-S18;C;265;21;78;9;187;12
60;2020-S18;D;80;3;39;2;41;1
60;2020-S18;E;283;21;63;2;220;19
60;2020-S19;0;1407;74;385;20;1022;54
60;2020-S19;A;21;0;8;0;13;0
60;2020-S19;B;430;16;127;5;303;11
60;2020-S19;C;299;12;103;4;196;8
60;2020-S19;D;105;9;42;3;63;6
60;2020-S19;E;552;37;105;8;447;29
60;2020-S20;0;2026;46;694;23;1332;23
60;2020-S20;A;57;2;27;2;30;0
60;2020-S20;B;590;9;217;4;373;5
60;2020-S20;C;526;16;203;8;323;8
60;2020-S20;D;178;2;81;1;97;1
60;2020-S20;E;673;17;166;8;507;9
60;2020-S21;0;1133;24;474;10;659;14
60;2020-S21;A;47;1;27;0;20;1
60;2020-S21;B;384;9;175;4;209;5
60;2020-S21;C;338;4;161;3;177;1
60;2020-S21;D;133;3;63;2;70;1
60;2020-S21;E;231;7;48;1;183;6
61;2020-S11;0;9;1;6;1;3;0
61;2020-S11;A;0;0;0;0;0;0
61;2020-S11;B;5;0;2;0;3;0
61;2020-S11;C;2;1;2;1;0;0
61;2020-S11;D;1;0;1;0;0;0
61;2020-S11;E;1;0;1;0;0;0
61;2020-S12;0;61;7;24;2;37;5
61;2020-S12;A;6;0;2;0;4;0
61;2020-S12;B;25;2;11;1;14;1
61;2020-S12;C;19;4;6;0;13;4
61;2020-S12;D;3;0;1;0;2;0
61;2020-S12;E;8;1;4;1;4;0
61;2020-S13;0;149;20;52;8;97;12
61;2020-S13;A;6;0;4;0;2;0
61;2020-S13;B;60;3;12;1;48;2
61;2020-S13;C;54;12;18;5;36;7
61;2020-S13;D;11;3;7;1;4;2
61;2020-S13;E;18;2;11;1;7;1
61;2020-S14;0;133;8;54;4;79;4
61;2020-S14;A;4;0;1;0;3;0
61;2020-S14;B;60;2;21;1;39;1
61;2020-S14;C;35;2;17;2;18;0
61;2020-S14;D;17;1;9;1;8;0
61;2020-S14;E;17;3;6;0;11;3
61;2020-S15;0;119;12;45;5;74;7
61;2020-S15;A;2;0;0;0;2;0
61;2020-S15;B;48;5;21;3;27;2
61;2020-S15;C;45;3;17;2;28;1
61;2020-S15;D;10;3;2;0;8;3
61;2020-S15;E;14;1;5;0;9;1
61;2020-S16;0;144;11;35;6;109;5
61;2020-S16;A;0;0;0;0;0;0
61;2020-S16;B;66;4;13;2;53;2
61;2020-S16;C;61;4;14;2;47;2
61;2020-S16;D;9;2;5;1;4;1
61;2020-S16;E;6;1;3;1;3;0
61;2020-S17;0;153;22;72;15;81;7
61;2020-S17;A;0;0;0;0;0;0
61;2020-S17;B;69;12;34;10;35;2
61;2020-S17;C;47;6;25;4;22;2
61;2020-S17;D;19;1;10;1;9;0
61;2020-S17;E;18;3;3;0;15;3
61;2020-S18;0;102;8;48;5;54;3
61;2020-S18;A;4;0;0;0;4;0
61;2020-S18;B;52;4;31;3;21;1
61;2020-S18;C;23;1;11;1;12;0
61;2020-S18;D;10;1;3;0;7;1
61;2020-S18;E;13;2;3;1;10;1
61;2020-S19;0;225;6;78;4;147;2
61;2020-S19;A;3;0;2;0;1;0
61;2020-S19;B;120;1;40;1;80;0
61;2020-S19;C;66;2;21;2;45;0
61;2020-S19;D;11;1;4;0;7;1
61;2020-S19;E;25;2;11;1;14;1
61;2020-S20;0;151;1;67;1;84;0
61;2020-S20;A;7;0;2;0;5;0
61;2020-S20;B;47;0;17;0;30;0
61;2020-S20;C;40;0;14;0;26;0
61;2020-S20;D;31;0;19;0;12;0
61;2020-S20;E;26;1;15;1;11;0
61;2020-S21;0;103;0;46;0;57;0
61;2020-S21;A;9;0;5;0;4;0
61;2020-S21;B;30;0;14;0;16;0
61;2020-S21;C;33;0;17;0;16;0
61;2020-S21;D;21;0;8;0;13;0
61;2020-S21;E;10;0;2;0;8;0
62;2020-S11;0;2;1;1;0;1;1
62;2020-S11;A;0;0;0;0;0;0
62;2020-S11;B;1;1;0;0;1;1
62;2020-S11;C;0;0;0;0;0;0
62;2020-S11;D;1;0;1;0;0;0
62;2020-S11;E;0;0;0;0;0;0
62;2020-S12;0;21;2;9;1;12;1
62;2020-S12;A;1;0;1;0;0;0
62;2020-S12;B;8;0;0;0;8;0
62;2020-S12;C;7;1;6;0;1;1
62;2020-S12;D;2;1;1;1;1;0
62;2020-S12;E;3;0;1;0;2;0
62;2020-S13;0;134;27;48;12;86;15
62;2020-S13;A;0;0;0;0;0;0
62;2020-S13;B;38;6;8;1;30;5
62;2020-S13;C;40;10;18;3;22;7
62;2020-S13;D;24;7;15;6;9;1
62;2020-S13;E;32;4;7;2;25;2
62;2020-S14;0;380;83;111;27;269;56
62;2020-S14;A;7;0;5;0;2;0
62;2020-S14;B;182;29;48;6;134;23
62;2020-S14;C;130;37;33;12;97;25
62;2020-S14;D;29;8;15;7;14;1
62;2020-S14;E;32;9;10;2;22;7
62;2020-S15;0;699;140;210;32;489;108
62;2020-S15;A;12;0;8;0;4;0
62;2020-S15;B;277;39;77;9;200;30
62;2020-S15;C;246;53;67;10;179;43
62;2020-S15;D;55;10;29;6;26;4
62;2020-S15;E;109;38;29;7;80;31
62;2020-S16;0;490;91;179;25;311;66
62;2020-S16;A;18;0;10;0;8;0
62;2020-S16;B;208;41;67;12;141;29
62;2020-S16;C;158;27;58;5;100;22
62;2020-S16;D;41;9;23;3;18;6
62;2020-S16;E;65;14;21;5;44;9
62;2020-S17;0;796;73;288;22;508;51
62;2020-S17;A;10;0;9;0;1;0
62;2020-S17;B;349;27;112;8;237;19
62;2020-S17;C;239;21;96;9;143;12
62;2020-S17;D;54;4;27;1;27;3
62;2020-S17;E;144;21;44;4;100;17
62;2020-S18;0;692;83;249;29;443;54
62;2020-S18;A;9;1;4;1;5;0
62;2020-S18;B;243;15;87;6;156;9
62;2020-S18;C;230;19;84;7;146;12
62;2020-S18;D;51;4;25;3;26;1
62;2020-S18;E;159;44;49;12;110;32
62;2020-S19;0;939;31;298;6;641;25
62;2020-S19;A;24;0;11;0;13;0
62;2020-S19;B;323;16;96;1;227;15
62;2020-S19;C;253;12;88;4;165;8
62;2020-S19;D;96;1;47;0;49;1
62;2020-S19;E;237;2;55;1;182;1
62;2020-S20;0;1287;19;554;8;733;11
62;2020-S20;A;62;0;31;0;31;0
62;2020-S20;B;454;6;205;2;249;4
62;2020-S20;C;427;9;191;5;236;4
62;2020-S20;D;142;3;70;1;72;2
62;2020-S20;E;202;1;57;0;145;1
62;2020-S21;0;1253;14;510;9;743;5
62;2020-S21;A;90;0;43;0;47;0
62;2020-S21;B;481;7;191;3;290;4
62;2020-S21;C;338;6;149;5;189;1
62;2020-S21;D;178;1;81;1;97;0
62;2020-S21;E;166;0;46;0;120;0
63;2020-S11;0;0;0;0;0;0;0
63;2020-S11;A;0;0;0;0;0;0
63;2020-S11;B;0;0;0;0;0;0
63;2020-S11;C;0;0;0;0;0;0
63;2020-S11;D;0;0;0;0;0;0
63;2020-S11;E;0;0;0;0;0;0
63;2020-S12;0;135;10;56;4;79;6
63;2020-S12;A;0;0;0;0;0;0
63;2020-S12;B;57;6;17;3;40;3
63;2020-S12;C;52;1;22;0;30;1
63;2020-S12;D;7;1;5;0;2;1
63;2020-S12;E;17;2;12;1;5;1
63;2020-S13;0;476;33;152;8;324;25
63;2020-S13;A;6;0;4;0;2;0
63;2020-S13;B;173;11;49;2;124;9
63;2020-S13;C;155;13;45;2;110;11
63;2020-S13;D;54;6;26;4;28;2
63;2020-S13;E;88;3;28;0;60;3
63;2020-S14;0;794;60;274;17;520;43
63;2020-S14;A;9;0;3;0;6;0
63;2020-S14;B;360;22;109;4;251;18
63;2020-S14;C;246;25;80;7;166;18
63;2020-S14;D;68;5;33;3;35;2
63;2020-S14;E;111;8;49;3;62;5
63;2020-S15;0;737;54;246;13;491;41
63;2020-S15;A;13;0;5;0;8;0
63;2020-S15;B;253;17;78;3;175;14
63;2020-S15;C;236;20;76;2;160;18
63;2020-S15;D;74;5;33;2;41;3
63;2020-S15;E;160;12;54;6;106;6
63;2020-S16;0;1016;38;330;8;686;30
63;2020-S16;A;22;0;11;0;11;0
63;2020-S16;B;345;5;102;0;243;5
63;2020-S16;C;347;11;108;3;239;8
63;2020-S16;D;92;6;46;1;46;5
63;2020-S16;E;210;16;63;4;147;12
63;2020-S17;0;1032;18;371;6;661;12
63;2020-S17;A;18;0;13;0;5;0
63;2020-S17;B;313;8;87;2;226;6
63;2020-S17;C;385;4;113;1;272;3
63;2020-S17;D;133;2;76;1;57;1
63;2020-S17;E;180;4;81;2;99;2
63;2020-S18;0;465;2;180;1;285;1
63;2020-S18;A;7;0;3;0;4;0
63;2020-S18;B;139;1;37;1;102;0
63;2020-S18;C;173;0;57;0;116;0
63;2020-S18;D;61;0;41;0;20;0
63;2020-S18;E;83;1;40;0;43;1
63;2020-S19;0;734;12;284;1;448;11
63;2020-S19;A;7;0;3;0;4;0
63;2020-S19;B;237;0;74;0;161;0
63;2020-S19;C;226;3;87;0;139;3
63;2020-S19;D;111;0;57;0;54;0
63;2020-S19;E;152;9;63;1;89;8
63;2020-S20;0;1526;5;653;2;868;3
63;2020-S20;A;81;0;44;0;36;0
63;2020-S20;B;496;2;206;0;288;2
63;2020-S20;C;466;2;175;1;289;1
63;2020-S20;D;184;1;108;1;76;0
63;2020-S20;E;297;0;120;0;177;0
63;2020-S21;0;1138;1;533;0;604;1
63;2020-S21;A;94;0;58;0;36;0
63;2020-S21;B;373;1;155;0;218;1
63;2020-S21;C;324;0;144;0;179;0
63;2020-S21;D;178;0;105;0;73;0
63;2020-S21;E;169;0;71;0;98;0
64;2020-S11;0;41;0;21;0;20;0
64;2020-S11;A;5;0;3;0;2;0
64;2020-S11;B;16;0;10;0;6;0
64;2020-S11;C;13;0;5;0;8;0
64;2020-S11;D;3;0;1;0;2;0
64;2020-S11;E;4;0;2;0;2;0
64;2020-S12;0;175;21;70;9;105;12
64;2020-S12;A;5;0;1;0;4;0
64;2020-S12;B;83;11;28;5;55;6
64;2020-S12;C;62;7;26;2;36;5
64;2020-S12;D;7;2;4;2;3;0
64;2020-S12;E;17;1;10;0;7;1
64;2020-S13;0;187;23;48;10;139;13
64;2020-S13;A;1;0;0;0;1;0
64;2020-S13;B;90;8;18;4;72;4
64;2020-S13;C;53;8;16;2;37;6
64;2020-S13;D;12;3;4;2;8;1
64;2020-S13;E;31;4;10;2;21;2
64;2020-S14;0;394;35;95;7;299;28
64;2020-S14;A;1;0;0;0;1;0
64;2020-S14;B;211;15;35;1;176;14
64;2020-S14;C;133;13;41;3;92;10
64;2020-S14;D;19;2;8;1;11;1
64;2020-S14;E;30;5;11;2;19;3
64;2020-S15;0;502;24;141;6;360;18
64;2020-S15;A;6;1;1;0;4;1
64;2020-S15;B;198;7;44;2;154;5
64;2020-S15;C;189;9;58;2;131;7
64;2020-S15;D;39;0;19;0;20;0
64;2020-S15;E;69;7;18;2;51;5
64;2020-S16;0;768;39;219;7;549;32
64;2020-S16;A;4;0;3;0;1;0
64;2020-S16;B;287;3;66;0;221;3
64;2020-S16;C;242;3;72;0;170;3
64;2020-S16;D;68;3;32;1;36;2
64;2020-S16;E;166;30;46;6;120;24
64;2020-S17;0;1360;35;313;9;1045;26
64;2020-S17;A;6;0;2;0;2;0
64;2020-S17;B;370;8;70;3;300;5
64;2020-S17;C;371;4;70;1;301;3
64;2020-S17;D;92;0;44;0;48;0
64;2020-S17;E;521;23;127;5;394;18
64;2020-S18;0;941;5;229;4;707;1
64;2020-S18;A;6;0;0;0;5;0
64;2020-S18;B;317;2;72;1;243;1
64;2020-S18;C;308;0;70;0;238;0
64;2020-S18;D;47;1;22;1;25;0
64;2020-S18;E;257;2;61;2;194;0
64;2020-S19;0;905;3;216;0;658;2
64;2020-S19;A;13;1;6;0;5;0
64;2020-S19;B;379;1;86;0;274;1
64;2020-S19;C;399;1;71;0;318;1
64;2020-S19;D;40;0;20;0;20;0
64;2020-S19;E;71;0;33;0;38;0
64;2020-S20;0;1771;44;476;5;1290;39
64;2020-S20;A;70;1;39;0;29;1
64;2020-S20;B;606;10;166;0;438;10
64;2020-S20;C;612;9;135;1;477;8
64;2020-S20;D;108;2;44;0;63;2
64;2020-S20;E;362;22;86;4;276;18
64;2020-S21;0;1360;2;288;2;1070;0
64;2020-S21;A;40;0;17;0;22;0
64;2020-S21;B;480;1;116;1;364;0
64;2020-S21;C;568;1;83;1;484;0
64;2020-S21;D;99;0;34;0;65;0
64;2020-S21;E;164;0;37;0;127;0
65;2020-S11;0;10;1;7;1;3;0
65;2020-S11;A;2;0;1;0;1;0
65;2020-S11;B;2;0;1;0;1;0
65;2020-S11;C;4;1;4;1;0;0
65;2020-S11;D;2;0;1;0;1;0
65;2020-S11;E;0;0;0;0;0;0
65;2020-S12;0;20;1;3;0;17;1
65;2020-S12;A;0;0;0;0;0;0
65;2020-S12;B;9;0;1;0;8;0
65;2020-S12;C;10;1;1;0;9;1
65;2020-S12;D;0;0;0;0;0;0
65;2020-S12;E;0;0;0;0;0;0
65;2020-S13;0;41;13;15;7;26;6
65;2020-S13;A;1;1;0;0;1;1
65;2020-S13;B;12;4;4;3;8;1
65;2020-S13;C;23;8;10;4;13;4
65;2020-S13;D;1;0;0;0;1;0
65;2020-S13;E;4;0;1;0;3;0
65;2020-S14;0;290;38;76;9;214;29
65;2020-S14;A;4;0;1;0;3;0
65;2020-S14;B;116;8;27;2;89;6
65;2020-S14;C;87;14;24;4;63;10
65;2020-S14;D;23;0;10;0;13;0
65;2020-S14;E;58;16;13;3;45;13
65;2020-S15;0;283;34;108;10;173;24
65;2020-S15;A;4;0;2;0;0;0
65;2020-S15;B;82;7;29;0;53;7
65;2020-S15;C;82;10;26;3;56;7
65;2020-S15;D;34;2;19;2;15;0
65;2020-S15;E;80;15;32;5;48;10
65;2020-S16;0;465;67;105;14;359;53
65;2020-S16;A;2;0;1;0;1;0
65;2020-S16;B;81;6;22;2;58;4
65;2020-S16;C;82;4;16;0;66;4
65;2020-S16;D;38;7;21;2;17;5
65;2020-S16;E;260;50;45;10;215;40
65;2020-S17;0;480;12;124;7;355;5
65;2020-S17;A;9;0;4;0;4;0
65;2020-S17;B;159;4;30;1;129;3
65;2020-S17;C;142;3;39;2;103;1
65;2020-S17;D;24;1;13;1;11;0
65;2020-S17;E;146;4;38;3;108;1
65;2020-S18;0;291;10;112;2;179;8
65;2020-S18;A;2;0;2;0;0;0
65;2020-S18;B;73;3;21;1;52;2
65;2020-S18;C;97;5;43;1;54;4
65;2020-S18;D;19;0;11;0;8;0
65;2020-S18;E;99;2;35;0;64;2
65;2020-S19;0;230;1;97;0;133;1
65;2020-S19;A;6;0;2;0;4;0
65;2020-S19;B;52;0;22;0;30;0
65;2020-S19;C;54;0;21;0;33;0
65;2020-S19;D;38;0;19;0;19;0
65;2020-S19;E;80;1;33;0;47;1
65;2020-S20;0;429;2;201;0;224;2
65;2020-S20;A;12;0;4;0;4;0
65;2020-S20;B;175;0;92;0;83;0
65;2020-S20;C;147;1;60;0;87;1
65;2020-S20;D;49;0;27;0;22;0
65;2020-S20;E;46;1;18;0;28;1
65;2020-S21;0;302;3;115;0;183;3
65;2020-S21;A;9;0;0;0;5;0
65;2020-S21;B;95;0;37;0;58;0
65;2020-S21;C;83;0;40;0;43;0
65;2020-S21;D;39;0;13;0;26;0
65;2020-S21;E;75;3;24;0;51;3
66;2020-S11;0;0;0;0;0;0;0
66;2020-S11;A;0;0;0;0;0;0
66;2020-S11;B;0;0;0;0;0;0
66;2020-S11;C;0;0;0;0;0;0
66;2020-S11;D;0;0;0;0;0;0
66;2020-S11;E;0;0;0;0;0;0
66;2020-S12;0;4;0;2;0;2;0
66;2020-S12;A;0;0;0;0;0;0
66;2020-S12;B;1;0;0;0;1;0
66;2020-S12;C;2;0;1;0;1;0
66;2020-S12;D;1;0;1;0;0;0
66;2020-S12;E;0;0;0;0;0;0
66;2020-S13;0;32;3;11;1;21;2
66;2020-S13;A;1;0;0;0;1;0
66;2020-S13;B;16;3;3;1;13;2
66;2020-S13;C;10;0;3;0;7;0
66;2020-S13;D;2;0;2;0;0;0
66;2020-S13;E;2;0;2;0;0;0
66;2020-S14;0;155;7;42;2;112;5
66;2020-S14;A;1;0;0;0;1;0
66;2020-S14;B;69;0;14;0;54;0
66;2020-S14;C;62;5;20;2;42;3
66;2020-S14;D;7;1;4;0;3;1
66;2020-S14;E;16;1;4;0;12;1
66;2020-S15;0;288;12;91;5;195;7
66;2020-S15;A;1;0;0;0;0;0
66;2020-S15;B;130;5;37;2;92;3
66;2020-S15;C;121;5;35;1;86;4
66;2020-S15;D;22;2;14;2;8;0
66;2020-S15;E;14;0;5;0;9;0
66;2020-S16;0;281;3;72;1;206;2
66;2020-S16;A;9;0;5;0;2;0
66;2020-S16;B;120;3;24;1;95;2
66;2020-S16;C;82;0;18;0;64;0
66;2020-S16;D;20;0;7;0;13;0
66;2020-S16;E;50;0;18;0;32;0
66;2020-S17;0;651;6;211;2;439;4
66;2020-S17;A;9;0;5;0;4;0
66;2020-S17;B;175;1;53;0;121;1
66;2020-S17;C;182;4;64;2;118;2
66;2020-S17;D;53;1;26;0;27;1
66;2020-S17;E;231;0;62;0;169;0
66;2020-S18;0;747;3;215;1;532;2
66;2020-S18;A;4;0;3;0;1;0
66;2020-S18;B;194;1;55;0;139;1
66;2020-S18;C;214;1;65;1;149;0
66;2020-S18;D;43;0;21;0;22;0
66;2020-S18;E;292;1;71;0;221;1
66;2020-S19;0;919;1;342;0;576;1
66;2020-S19;A;28;0;19;0;9;0
66;2020-S19;B;319;0;112;0;206;0
66;2020-S19;C;309;1;122;0;187;1
66;2020-S19;D;91;0;37;0;54;0
66;2020-S19;E;153;0;51;0;102;0
66;2020-S20;0;1277;0;522;0;752;0
66;2020-S20;A;59;0;28;0;28;0
66;2020-S20;B;423;0;186;0;237;0
66;2020-S20;C;417;0;156;0;261;0
66;2020-S20;D;167;0;89;0;78;0
66;2020-S20;E;211;0;63;0;148;0
66;2020-S21;0;956;0;458;0;494;0
66;2020-S21;A;74;0;42;0;29;0
66;2020-S21;B;314;0;153;0;160;0
66;2020-S21;C;280;0;126;0;154;0
66;2020-S21;D;117;0;64;0;53;0
66;2020-S21;E;171;0;73;0;98;0
67;2020-S11;0;4;1;3;1;1;0
67;2020-S11;A;0;0;0;0;0;0
67;2020-S11;B;1;0;0;0;1;0
67;2020-S11;C;0;0;0;0;0;0
67;2020-S11;D;2;0;2;0;0;0
67;2020-S11;E;1;1;1;1;0;0
67;2020-S12;0;18;4;4;0;14;4
67;2020-S12;A;0;0;0;0;0;0
67;2020-S12;B;9;2;2;0;7;2
67;2020-S12;C;6;1;2;0;4;1
67;2020-S12;D;0;0;0;0;0;0
67;2020-S12;E;3;1;0;0;3;1
67;2020-S13;0;281;98;89;36;192;62
67;2020-S13;A;1;0;0;0;1;0
67;2020-S13;B;103;25;24;7;79;18
67;2020-S13;C;106;47;34;15;72;32
67;2020-S13;D;28;15;15;9;13;6
67;2020-S13;E;43;11;16;5;27;6
67;2020-S14;0;499;136;141;42;358;94
67;2020-S14;A;2;1;2;1;0;0
67;2020-S14;B;230;65;58;20;172;45
67;2020-S14;C;191;47;53;13;138;34
67;2020-S14;D;32;8;14;1;18;7
67;2020-S14;E;44;15;14;7;30;8
67;2020-S15;0;347;75;118;26;229;49
67;2020-S15;A;4;0;2;0;2;0
67;2020-S15;B;134;26;38;7;96;19
67;2020-S15;C;126;22;40;7;86;15
67;2020-S15;D;38;5;24;5;14;0
67;2020-S15;E;45;22;14;7;31;15
67;2020-S16;0;443;116;117;23;326;93
67;2020-S16;A;5;0;4;0;1;0
67;2020-S16;B;119;22;31;5;88;17
67;2020-S16;C;115;23;32;4;83;19
67;2020-S16;D;45;10;15;2;30;8
67;2020-S16;E;159;61;35;12;124;49
67;2020-S17;0;318;23;95;5;223;18
67;2020-S17;A;2;0;2;0;0;0
67;2020-S17;B;56;5;23;1;33;4
67;2020-S17;C;65;6;21;2;44;4
67;2020-S17;D;21;1;12;1;9;0
67;2020-S17;E;173;11;37;1;136;10
67;2020-S18;0;121;20;37;1;84;19
67;2020-S18;A;3;0;3;0;0;0
67;2020-S18;B;23;1;8;0;15;1
67;2020-S18;C;19;1;8;0;11;1
67;2020-S18;D;8;0;3;0;5;0
67;2020-S18;E;68;18;15;1;53;17
67;2020-S19;0;72;12;26;4;46;8
67;2020-S19;A;0;0;0;0;0;0
67;2020-S19;B;17;0;7;0;10;0
67;2020-S19;C;20;2;9;1;11;1
67;2020-S19;D;5;0;2;0;3;0
67;2020-S19;E;30;10;8;3;22;7
67;2020-S20;0;653;39;299;11;354;28
67;2020-S20;A;29;1;17;1;12;0
67;2020-S20;B;223;4;121;1;102;3
67;2020-S20;C;189;3;81;2;108;1
67;2020-S20;D;72;3;42;2;30;1
67;2020-S20;E;140;28;38;5;102;23
67;2020-S21;0;784;15;327;3;457;12
67;2020-S21;A;52;0;30;0;22;0
67;2020-S21;B;306;2;116;0;190;2
67;2020-S21;C;288;2;125;1;163;1
67;2020-S21;D;80;3;40;1;40;2
67;2020-S21;E;58;8;16;1;42;7
68;2020-S11;0;43;21;18;7;25;14
68;2020-S11;A;0;0;0;0;0;0
68;2020-S11;B;4;1;0;0;4;1
68;2020-S11;C;8;3;6;1;2;2
68;2020-S11;D;9;6;5;3;4;3
68;2020-S11;E;22;11;7;3;15;8
68;2020-S12;0;161;75;58;29;103;46
68;2020-S12;A;2;0;1;0;1;0
68;2020-S12;B;56;19;11;2;45;17
68;2020-S12;C;51;28;22;12;29;16
68;2020-S12;D;21;11;12;10;9;1
68;2020-S12;E;31;17;12;5;19;12
68;2020-S13;0;409;173;117;64;292;109
68;2020-S13;A;2;0;1;0;1;0
68;2020-S13;B;131;51;23;11;108;40
68;2020-S13;C;163;64;47;27;116;37
68;2020-S13;D;42;20;22;11;20;9
68;2020-S13;E;71;38;24;15;47;23
68;2020-S14;0;982;340;358;122;624;218
68;2020-S14;A;12;0;4;0;8;0
68;2020-S14;B;343;96;95;20;248;76
68;2020-S14;C;386;137;145;49;241;88
68;2020-S14;D;88;30;52;19;36;11
68;2020-S14;E;153;77;62;34;91;43
68;2020-S15;0;811;174;340;69;471;105
68;2020-S15;A;17;0;11;0;6;0
68;2020-S15;B;295;55;126;17;169;38
68;2020-S15;C;313;55;122;24;191;31
68;2020-S15;D;63;13;33;8;30;5
68;2020-S15;E;123;51;48;20;75;31
68;2020-S16;0;698;115;255;37;443;78
68;2020-S16;A;12;0;7;0;5;0
68;2020-S16;B;240;28;98;10;142;18
68;2020-S16;C;218;29;75;8;143;21
68;2020-S16;D;49;9;18;7;31;2
68;2020-S16;E;162;49;55;12;107;37
68;2020-S17;0;198;27;67;6;131;21
68;2020-S17;A;2;0;2;0;0;0
68;2020-S17;B;35;3;11;1;24;2
68;2020-S17;C;44;3;18;2;26;1
68;2020-S17;D;13;0;7;0;6;0
68;2020-S17;E;103;21;28;3;75;18
68;2020-S18;0;127;20;47;5;80;15
68;2020-S18;A;1;0;0;0;1;0
68;2020-S18;B;29;0;8;0;21;0
68;2020-S18;C;26;1;13;1;13;0
68;2020-S18;D;14;1;6;1;8;0
68;2020-S18;E;57;18;20;3;37;15
68;2020-S19;0;117;1;32;0;85;1
68;2020-S19;A;5;0;2;0;3;0
68;2020-S19;B;44;0;9;0;35;0
68;2020-S19;C;38;1;12;0;26;1
68;2020-S19;D;8;0;1;0;7;0
68;2020-S19;E;22;0;8;0;14;0
68;2020-S20;0;438;12;153;6;285;6
68;2020-S20;A;25;0;11;0;14;0
68;2020-S20;B;150;2;47;1;103;1
68;2020-S20;C;144;4;57;2;87;2
68;2020-S20;D;32;0;20;0;12;0
68;2020-S20;E;87;6;18;3;69;3
68;2020-S21;0;35;1;13;0;22;1
68;2020-S21;A;4;0;3;0;1;0
68;2020-S21;B;12;0;2;0;10;0
68;2020-S21;C;14;1;6;0;8;1
68;2020-S21;D;2;0;1;0;1;0
68;2020-S21;E;3;0;1;0;2;0
69;2020-S11;0;25;1;24;1;1;0
69;2020-S11;A;0;0;0;0;0;0
69;2020-S11;B;21;1;20;1;1;0
69;2020-S11;C;3;0;3;0;0;0
69;2020-S11;D;1;0;1;0;0;0
69;2020-S11;E;0;0;0;0;0;0
69;2020-S12;0;290;70;95;26;195;44
69;2020-S12;A;9;0;4;0;5;0
69;2020-S12;B;126;23;35;8;91;15
69;2020-S12;C;87;27;27;7;60;20
69;2020-S12;D;27;13;15;9;12;4
69;2020-S12;E;41;7;14;2;27;5
69;2020-S13;0;126;30;47;15;79;15
69;2020-S13;A;0;0;0;0;0;0
69;2020-S13;B;41;6;16;4;25;2
69;2020-S13;C;38;13;11;5;27;8
69;2020-S13;D;14;4;6;2;8;2
69;2020-S13;E;33;7;14;4;19;3
69;2020-S14;0;351;57;120;23;231;34
69;2020-S14;A;3;0;2;0;1;0
69;2020-S14;B;141;17;35;7;106;10
69;2020-S14;C;119;19;43;6;76;13
69;2020-S14;D;40;9;23;6;17;3
69;2020-S14;E;47;11;17;4;30;7
69;2020-S15;0;453;85;135;21;318;64
69;2020-S15;A;11;0;7;0;4;0
69;2020-S15;B;192;36;61;8;131;28
69;2020-S15;C;138;25;36;5;102;20
69;2020-S15;D;47;6;12;3;35;3
69;2020-S15;E;65;18;19;5;46;13
69;2020-S16;0;390;33;124;11;266;22
69;2020-S16;A;6;0;4;0;2;0
69;2020-S16;B;146;15;45;6;101;9
69;2020-S16;C;97;9;29;3;68;6
69;2020-S16;D;29;1;15;1;14;0
69;2020-S16;E;112;8;31;1;81;7
69;2020-S17;0;532;40;175;11;357;29
69;2020-S17;A;12;0;7;0;5;0
69;2020-S17;B;174;15;53;4;121;11
69;2020-S17;C;145;8;47;3;98;5
69;2020-S17;D;40;1;22;0;18;1
69;2020-S17;E;161;16;46;4;115;12
69;2020-S18;0;215;20;72;7;143;13
69;2020-S18;A;5;0;2;0;3;0
69;2020-S18;B;92;4;31;1;61;3
69;2020-S18;C;49;6;21;2;28;4
69;2020-S18;D;14;1;9;1;5;0
69;2020-S18;E;55;9;9;3;46;6
69;2020-S19;0;47;8;11;2;36;6
69;2020-S19;A;0;0;0;0;0;0
69;2020-S19;B;14;1;1;0;13;1
69;2020-S19;C;8;0;2;0;6;0
69;2020-S19;D;3;0;1;0;2;0
69;2020-S19;E;22;7;7;2;15;5
69;2020-S20;0;117;1;58;1;59;0
69;2020-S20;A;6;0;4;0;2;0
69;2020-S20;B;57;1;31;1;26;0
69;2020-S20;C;29;0;11;0;18;0
69;2020-S20;D;8;0;6;0;2;0
69;2020-S20;E;17;0;6;0;11;0
69;2020-S21;0;26;0;10;0;16;0
69;2020-S21;A;2;0;1;0;1;0
69;2020-S21;B;16;0;6;0;10;0
69;2020-S21;C;5;0;2;0;3;0
69;2020-S21;D;3;0;1;0;2;0
69;2020-S21;E;0;0;0;0;0;0
70;2020-S11;0;1;0;0;0;1;0
70;2020-S11;A;0;0;0;0;0;0
70;2020-S11;B;1;0;0;0;1;0
70;2020-S11;C;0;0;0;0;0;0
70;2020-S11;D;0;0;0;0;0;0
70;2020-S11;E;0;0;0;0;0;0
70;2020-S12;0;57;23;22;11;35;12
70;2020-S12;A;0;0;0;0;0;0
70;2020-S12;B;19;8;6;3;13;5
70;2020-S12;C;26;10;10;6;16;4
70;2020-S12;D;4;1;2;0;2;1
70;2020-S12;E;7;3;3;1;4;2
70;2020-S13;0;220;73;85;30;135;43
70;2020-S13;A;3;0;1;0;2;0
70;2020-S13;B;76;13;20;2;56;11
70;2020-S13;C;83;29;38;13;45;16
70;2020-S13;D;32;15;15;9;17;6
70;2020-S13;E;26;16;11;6;15;10
70;2020-S14;0;191;34;65;12;126;22
70;2020-S14;A;0;0;0;0;0;0
70;2020-S14;B;72;8;17;0;55;8
70;2020-S14;C;75;16;30;8;45;8
70;2020-S14;D;24;4;12;2;12;2
70;2020-S14;E;20;6;6;2;14;4
70;2020-S15;0;197;43;63;16;134;27
70;2020-S15;A;4;0;1;0;3;0
70;2020-S15;B;58;10;7;1;51;9
70;2020-S15;C;94;22;35;11;59;11
70;2020-S15;D;24;4;12;1;12;3
70;2020-S15;E;17;7;8;3;9;4
70;2020-S16;0;228;60;72;23;156;37
70;2020-S16;A;2;0;0;0;2;0
70;2020-S16;B;85;22;28;5;57;17
70;2020-S16;C;99;27;25;11;74;16
70;2020-S16;D;24;7;10;4;14;3
70;2020-S16;E;16;4;8;3;8;1
70;2020-S17;0;353;14;80;2;273;12
70;2020-S17;A;1;0;0;0;1;0
70;2020-S17;B;140;7;30;1;110;6
70;2020-S17;C;121;5;23;1;98;4
70;2020-S17;D;18;2;10;0;8;2
70;2020-S17;E;73;0;17;0;56;0
70;2020-S18;0;291;18;74;5;217;13
70;2020-S18;A;2;0;1;0;1;0
70;2020-S18;B;63;4;14;1;49;3
70;2020-S18;C;56;6;14;2;42;4
70;2020-S18;D;23;1;11;0;12;1
70;2020-S18;E;147;7;34;2;113;5
70;2020-S19;0;465;10;137;2;328;8
70;2020-S19;A;6;0;2;0;4;0
70;2020-S19;B;166;3;47;1;119;2
70;2020-S19;C;171;4;58;0;113;4
70;2020-S19;D;25;1;11;1;14;0
70;2020-S19;E;97;2;19;0;78;2
70;2020-S20;0;492;3;141;1;351;2
70;2020-S20;A;16;0;6;0;10;0
70;2020-S20;B;181;2;60;1;121;1
70;2020-S20;C;226;0;47;0;179;0
70;2020-S20;D;26;0;9;0;17;0
70;2020-S20;E;43;1;19;0;24;1
70;2020-S21;0;418;0;123;0;295;0
70;2020-S21;A;16;0;7;0;9;0
70;2020-S21;B;176;0;40;0;136;0
70;2020-S21;C;179;0;52;0;127;0
70;2020-S21;D;24;0;11;0;13;0
70;2020-S21;E;23;0;13;0;10;0
71;2020-S11;0;0;0;0;0;0;0
71;2020-S11;A;0;0;0;0;0;0
71;2020-S11;B;0;0;0;0;0;0
71;2020-S11;C;0;0;0;0;0;0
71;2020-S11;D;0;0;0;0;0;0
71;2020-S11;E;0;0;0;0;0;0
71;2020-S12;0;52;6;22;2;30;4
71;2020-S12;A;3;0;2;0;1;0
71;2020-S12;B;12;4;3;1;9;3
71;2020-S12;C;13;0;2;0;11;0
71;2020-S12;D;6;0;3;0;3;0
71;2020-S12;E;18;2;12;1;6;1
71;2020-S13;0;219;28;65;11;154;17
71;2020-S13;A;1;1;0;0;1;1
71;2020-S13;B;75;7;16;1;59;6
71;2020-S13;C;84;7;24;2;60;5
71;2020-S13;D;16;7;10;6;6;1
71;2020-S13;E;43;6;15;2;28;4
71;2020-S14;0;442;51;149;17;293;34
71;2020-S14;A;4;0;4;0;0;0
71;2020-S14;B;158;13;38;1;120;12
71;2020-S14;C;175;25;53;8;122;17
71;2020-S14;D;36;5;21;4;15;1
71;2020-S14;E;69;8;33;4;36;4
71;2020-S15;0;531;81;176;28;355;53
71;2020-S15;A;7;0;5;0;2;0
71;2020-S15;B;175;25;58;8;117;17
71;2020-S15;C;190;22;54;6;136;16
71;2020-S15;D;63;15;27;7;36;8
71;2020-S15;E;96;19;32;7;64;12
71;2020-S16;0;546;46;174;19;372;27
71;2020-S16;A;8;0;2;0;6;0
71;2020-S16;B;186;15;55;6;131;9
71;2020-S16;C;174;17;53;5;121;12
71;2020-S16;D;48;2;25;2;23;0
71;2020-S16;E;127;12;39;6;88;6
71;2020-S17;0;669;28;197;11;472;17
71;2020-S17;A;7;0;3;0;4;0
71;2020-S17;B;243;12;62;4;181;8
71;2020-S17;C;257;9;70;3;187;6
71;2020-S17;D;54;3;31;3;23;0
71;2020-S17;E;107;4;31;1;76;3
71;2020-S18;0;186;2;58;1;128;1
71;2020-S18;A;2;0;1;0;1;0
71;2020-S18;B;50;2;14;1;36;1
71;2020-S18;C;51;0;14;0;37;0
71;2020-S18;D;19;0;11;0;8;0
71;2020-S18;E;63;0;17;0;46;0
71;2020-S19;0;351;6;121;5;230;1
71;2020-S19;A;10;0;3;0;7;0
71;2020-S19;B;125;3;46;2;79;1
71;2020-S19;C;119;2;41;2;78;0
71;2020-S19;D;43;0;19;0;24;0
71;2020-S19;E;54;1;12;1;42;0
71;2020-S20;0;429;4;148;0;281;4
71;2020-S20;A;12;1;8;0;4;1
71;2020-S20;B;161;1;52;0;109;1
71;2020-S20;C;165;1;55;0;110;1
71;2020-S20;D;39;1;16;0;23;1
71;2020-S20;E;52;0;17;0;35;0
71;2020-S21;0;212;2;103;1;109;1
71;2020-S21;A;13;1;5;1;8;0
71;2020-S21;B;74;0;36;0;38;0
71;2020-S21;C;63;0;31;0;32;0
71;2020-S21;D;30;1;17;0;13;1
71;2020-S21;E;32;0;14;0;18;0
72;2020-S11;0;1;0;0;0;1;0
72;2020-S11;A;0;0;0;0;0;0
72;2020-S11;B;0;0;0;0;0;0
72;2020-S11;C;1;0;0;0;1;0
72;2020-S11;D;0;0;0;0;0;0
72;2020-S11;E;0;0;0;0;0;0
72;2020-S12;0;2;1;1;1;1;0
72;2020-S12;A;0;0;0;0;0;0
72;2020-S12;B;0;0;0;0;0;0
72;2020-S12;C;2;1;1;1;1;0
72;2020-S12;D;0;0;0;0;0;0
72;2020-S12;E;0;0;0;0;0;0
72;2020-S13;0;4;1;1;0;3;1
72;2020-S13;A;0;0;0;0;0;0
72;2020-S13;B;2;1;0;0;2;1
72;2020-S13;C;2;0;1;0;1;0
72;2020-S13;D;0;0;0;0;0;0
72;2020-S13;E;0;0;0;0;0;0
72;2020-S14;0;2;0;2;0;0;0
72;2020-S14;A;0;0;0;0;0;0
72;2020-S14;B;1;0;1;0;0;0
72;2020-S14;C;1;0;1;0;0;0
72;2020-S14;D;0;0;0;0;0;0
72;2020-S14;E;0;0;0;0;0;0
72;2020-S15;0;8;0;0;0;8;0
72;2020-S15;A;0;0;0;0;0;0
72;2020-S15;B;4;0;0;0;4;0
72;2020-S15;C;2;0;0;0;2;0
72;2020-S15;D;1;0;0;0;1;0
72;2020-S15;E;1;0;0;0;1;0
72;2020-S16;0;5;1;1;0;4;1
72;2020-S16;A;0;0;0;0;0;0
72;2020-S16;B;1;1;0;0;1;1
72;2020-S16;C;2;0;1;0;1;0
72;2020-S16;D;0;0;0;0;0;0
72;2020-S16;E;2;0;0;0;2;0
72;2020-S17;0;11;0;3;0;8;0
72;2020-S17;A;0;0;0;0;0;0
72;2020-S17;B;7;0;3;0;4;0
72;2020-S17;C;2;0;0;0;2;0
72;2020-S17;D;0;0;0;0;0;0
72;2020-S17;E;2;0;0;0;2;0
72;2020-S18;0;9;0;2;0;7;0
72;2020-S18;A;2;0;1;0;1;0
72;2020-S18;B;1;0;0;0;1;0
72;2020-S18;C;3;0;1;0;2;0
72;2020-S18;D;0;0;0;0;0;0
72;2020-S18;E;3;0;0;0;3;0
72;2020-S19;0;3;0;1;0;2;0
72;2020-S19;A;0;0;0;0;0;0
72;2020-S19;B;1;0;0;0;1;0
72;2020-S19;C;2;0;1;0;1;0
72;2020-S19;D;0;0;0;0;0;0
72;2020-S19;E;0;0;0;0;0;0
72;2020-S20;0;18;0;11;0;7;0
72;2020-S20;A;0;0;0;0;0;0
72;2020-S20;B;10;0;5;0;5;0
72;2020-S20;C;7;0;5;0;2;0
72;2020-S20;D;1;0;1;0;0;0
72;2020-S20;E;0;0;0;0;0;0
72;2020-S21;0;10;0;2;0;8;0
72;2020-S21;A;0;0;0;0;0;0
72;2020-S21;B;2;0;0;0;2;0
72;2020-S21;C;5;0;1;0;4;0
72;2020-S21;D;2;0;0;0;2;0
72;2020-S21;E;1;0;1;0;0;0
73;2020-S11;0;0;0;0;0;0;0
73;2020-S11;A;0;0;0;0;0;0
73;2020-S11;B;0;0;0;0;0;0
73;2020-S11;C;0;0;0;0;0;0
73;2020-S11;D;0;0;0;0;0;0
73;2020-S11;E;0;0;0;0;0;0
73;2020-S12;0;33;3;7;0;26;3
73;2020-S12;A;0;0;0;0;0;0
73;2020-S12;B;14;1;3;0;11;1
73;2020-S12;C;12;2;2;0;10;2
73;2020-S12;D;0;0;0;0;0;0
73;2020-S12;E;7;0;2;0;5;0
73;2020-S13;0;52;10;17;4;35;6
73;2020-S13;A;1;0;1;0;0;0
73;2020-S13;B;28;5;5;1;23;4
73;2020-S13;C;14;3;6;2;8;1
73;2020-S13;D;2;0;2;0;0;0
73;2020-S13;E;7;2;3;1;4;1
73;2020-S14;0;51;10;7;1;44;9
73;2020-S14;A;0;0;0;0;0;0
73;2020-S14;B;27;2;0;0;27;2
73;2020-S14;C;20;8;4;1;16;7
73;2020-S14;D;3;0;2;0;1;0
73;2020-S14;E;1;0;1;0;0;0
73;2020-S15;0;80;12;24;5;56;7
73;2020-S15;A;2;0;1;0;1;0
73;2020-S15;B;36;4;8;1;28;3
73;2020-S15;C;31;8;11;4;20;4
73;2020-S15;D;7;0;2;0;5;0
73;2020-S15;E;4;0;2;0;2;0
73;2020-S16;0;55;0;20;0;35;0
73;2020-S16;A;3;0;1;0;2;0
73;2020-S16;B;21;0;6;0;15;0
73;2020-S16;C;20;0;10;0;10;0
73;2020-S16;D;6;0;1;0;5;0
73;2020-S16;E;5;0;2;0;3;0
73;2020-S17;0;30;4;14;1;16;3
73;2020-S17;A;0;0;0;0;0;0
73;2020-S17;B;14;0;7;0;7;0
73;2020-S17;C;14;4;6;1;8;3
73;2020-S17;D;1;0;1;0;0;0
73;2020-S17;E;1;0;0;0;1;0
73;2020-S18;0;30;0;8;0;22;0
73;2020-S18;A;1;0;1;0;0;0
73;2020-S18;B;14;0;4;0;10;0
73;2020-S18;C;10;0;2;0;8;0
73;2020-S18;D;3;0;1;0;2;0
73;2020-S18;E;2;0;0;0;2;0
73;2020-S19;0;31;0;11;0;20;0
73;2020-S19;A;1;0;0;0;1;0
73;2020-S19;B;13;0;5;0;8;0
73;2020-S19;C;13;0;6;0;7;0
73;2020-S19;D;4;0;0;0;4;0
73;2020-S19;E;0;0;0;0;0;0
73;2020-S20;0;2;0;2;0;0;0
73;2020-S20;A;0;0;0;0;0;0
73;2020-S20;B;1;0;1;0;0;0
73;2020-S20;C;1;0;1;0;0;0
73;2020-S20;D;0;0;0;0;0;0
73;2020-S20;E;0;0;0;0;0;0
73;2020-S21;0;4;0;1;0;3;0
73;2020-S21;A;0;0;0;0;0;0
73;2020-S21;B;1;0;1;0;0;0
73;2020-S21;C;1;0;0;0;1;0
73;2020-S21;D;0;0;0;0;0;0
73;2020-S21;E;2;0;0;0;2;0
74;2020-S11;0;19;2;9;1;10;1
74;2020-S11;A;0;0;0;0;0;0
74;2020-S11;B;10;0;5;0;5;0
74;2020-S11;C;8;2;4;1;4;1
74;2020-S11;D;0;0;0;0;0;0
74;2020-S11;E;1;0;0;0;1;0
74;2020-S12;0;348;75;94;23;254;52
74;2020-S12;A;7;1;3;0;4;1
74;2020-S12;B;187;32;41;7;146;25
74;2020-S12;C;116;35;33;11;83;24
74;2020-S12;D;15;4;11;4;4;0
74;2020-S12;E;22;3;6;1;16;2
74;2020-S13;0;450;141;137;48;313;93
74;2020-S13;A;5;0;5;0;0;0
74;2020-S13;B;250;66;66;19;184;47
74;2020-S13;C;152;61;50;26;102;35
74;2020-S13;D;13;5;8;2;5;3
74;2020-S13;E;28;7;8;1;20;6
74;2020-S14;0;483;132;127;44;356;88
74;2020-S14;A;2;0;2;0;0;0
74;2020-S14;B;255;59;57;15;198;44
74;2020-S14;C;176;49;50;18;126;31
74;2020-S14;D;21;8;9;5;12;3
74;2020-S14;E;29;16;9;6;20;10
74;2020-S15;0;485;109;128;22;357;87
74;2020-S15;A;2;0;1;0;1;0
74;2020-S15;B;187;23;51;4;136;19
74;2020-S15;C;127;28;29;2;98;26
74;2020-S15;D;32;4;13;2;19;2
74;2020-S15;E;137;54;34;14;103;40
74;2020-S16;0;420;51;108;10;312;41
74;2020-S16;A;3;0;3;0;0;0
74;2020-S16;B;178;20;38;7;140;13
74;2020-S16;C;113;5;34;1;79;4
74;2020-S16;D;34;5;14;1;20;4
74;2020-S16;E;92;21;19;1;73;20
74;2020-S17;0;514;56;170;17;344;39
74;2020-S17;A;3;0;2;0;1;0
74;2020-S17;B;175;16;60;7;115;9
74;2020-S17;C;115;7;33;0;82;7
74;2020-S17;D;29;3;17;3;12;0
74;2020-S17;E;191;30;57;7;134;23
74;2020-S18;0;356;27;96;4;260;23
74;2020-S18;A;2;0;0;0;2;0
74;2020-S18;B;115;7;28;1;87;6
74;2020-S18;C;89;2;26;0;63;2
74;2020-S18;D;22;1;9;1;13;0
74;2020-S18;E;128;17;33;2;95;15
74;2020-S19;0;289;12;68;3;221;9
74;2020-S19;A;9;0;3;0;6;0
74;2020-S19;B;134;1;27;1;107;0
74;2020-S19;C;84;3;17;0;67;3
74;2020-S19;D;14;1;9;1;5;0
74;2020-S19;E;48;7;12;1;36;6
74;2020-S20;0;21;0;10;0;11;0
74;2020-S20;A;1;0;1;0;0;0
74;2020-S20;B;7;0;1;0;6;0
74;2020-S20;C;10;0;6;0;4;0
74;2020-S20;D;3;0;2;0;1;0
74;2020-S20;E;0;0;0;0;0;0
74;2020-S21;0;4;0;2;0;2;0
74;2020-S21;A;0;0;0;0;0;0
74;2020-S21;B;1;0;1;0;0;0
74;2020-S21;C;1;0;0;0;1;0
74;2020-S21;D;2;0;1;0;1;0
74;2020-S21;E;0;0;0;0;0;0
75;2020-S11;0;119;36;48;13;71;23
75;2020-S11;A;1;0;0;0;1;0
75;2020-S11;B;72;21;29;8;43;13
75;2020-S11;C;34;10;12;3;22;7
75;2020-S11;D;9;5;5;2;4;3
75;2020-S11;E;3;0;2;0;1;0
75;2020-S12;0;1077;452;421;194;656;258
75;2020-S12;A;6;2;4;2;2;0
75;2020-S12;B;564;218;196;84;368;134
75;2020-S12;C;348;150;141;63;207;87
75;2020-S12;D;84;40;45;24;39;16
75;2020-S12;E;74;41;35;21;39;20
75;2020-S13;0;2255;986;872;411;1383;575
75;2020-S13;A;7;0;5;0;2;0
75;2020-S13;B;961;413;363;167;598;246
75;2020-S13;C;704;316;280;140;424;176
75;2020-S13;D;189;76;91;31;98;45
75;2020-S13;E;394;181;133;73;261;108
75;2020-S14;0;2796;893;1158;344;1637;549
75;2020-S14;A;13;4;4;0;8;4
75;2020-S14;B;1071;331;445;135;626;196
75;2020-S14;C;869;250;367;106;502;144
75;2020-S14;D;288;78;152;33;136;45
75;2020-S14;E;555;230;190;70;365;160
75;2020-S15;0;2553;765;863;222;1690;543
75;2020-S15;A;16;3;6;0;10;3
75;2020-S15;B;834;202;317;74;517;128
75;2020-S15;C;698;171;236;47;462;124
75;2020-S15;D;258;64;122;29;136;35
75;2020-S15;E;739;324;180;72;559;252
75;2020-S16;0;2162;454;827;161;1335;293
75;2020-S16;A;8;1;1;1;7;0
75;2020-S16;B;715;127;335;54;380;73
75;2020-S16;C;432;85;175;34;257;51
75;2020-S16;D;211;39;96;20;115;19
75;2020-S16;E;793;202;219;52;574;150
75;2020-S17;0;1749;219;702;85;1047;134
75;2020-S17;A;8;0;4;0;4;0
75;2020-S17;B;695;73;285;31;410;42
75;2020-S17;C;532;54;229;21;303;33
75;2020-S17;D;157;22;81;12;76;10
75;2020-S17;E;354;69;102;21;252;48
75;2020-S18;0;1571;122;881;71;690;51
75;2020-S18;A;11;1;6;0;5;1
75;2020-S18;B;674;53;383;34;291;19
75;2020-S18;C;625;48;346;25;279;23
75;2020-S18;D;139;7;88;4;51;3
75;2020-S18;E;121;13;57;8;64;5
75;2020-S19;0;1067;91;509;57;558;34
75;2020-S19;A;18;0;7;0;11;0
75;2020-S19;B;405;40;193;24;212;16
75;2020-S19;C;362;28;189;24;173;4
75;2020-S19;D;123;11;58;6;65;5
75;2020-S19;E;159;12;62;3;97;9
75;2020-S20;0;1024;34;453;15;571;19
75;2020-S20;A;35;3;18;1;17;2
75;2020-S20;B;424;14;191;6;233;8
75;2020-S20;C;358;5;161;3;197;2
75;2020-S20;D;116;4;44;2;72;2
75;2020-S20;E;91;8;39;3;52;5
75;2020-S21;0;984;15;445;6;539;9
75;2020-S21;A;42;0;20;0;22;0
75;2020-S21;B;461;11;227;5;234;6
75;2020-S21;C;269;1;112;0;157;1
75;2020-S21;D;123;0;57;0;66;0
75;2020-S21;E;89;3;29;1;60;2
76;2020-S11;0;4;0;2;0;2;0
76;2020-S11;A;0;0;0;0;0;0
76;2020-S11;B;1;0;1;0;0;0
76;2020-S11;C;1;0;0;0;1;0
76;2020-S11;D;1;0;1;0;0;0
76;2020-S11;E;1;0;0;0;1;0
76;2020-S12;0;72;10;19;1;53;9
76;2020-S12;A;1;0;0;0;1;0
76;2020-S12;B;40;6;11;1;29;5
76;2020-S12;C;16;3;2;0;14;3
76;2020-S12;D;2;0;2;0;0;0
76;2020-S12;E;13;1;4;0;9;1
76;2020-S13;0;279;84;86;27;193;57
76;2020-S13;A;2;0;0;0;2;0
76;2020-S13;B;105;31;22;5;83;26
76;2020-S13;C;80;28;27;11;53;17
76;2020-S13;D;35;11;22;7;13;4
76;2020-S13;E;56;13;14;3;42;10
76;2020-S14;0;558;98;158;23;400;75
76;2020-S14;A;10;0;4;0;6;0
76;2020-S14;B;255;44;61;5;194;39
76;2020-S14;C;180;30;49;10;131;20
76;2020-S14;D;46;9;20;4;26;5
76;2020-S14;E;67;15;24;4;43;11
76;2020-S15;0;667;109;204;27;463;82
76;2020-S15;A;3;0;2;0;1;0
76;2020-S15;B;255;41;64;9;191;32
76;2020-S15;C;186;33;62;8;124;25
76;2020-S15;D;47;4;25;2;22;2
76;2020-S15;E;176;31;51;8;125;23
76;2020-S16;0;558;47;154;13;404;34
76;2020-S16;A;9;0;6;0;3;0
76;2020-S16;B;227;6;59;1;168;5
76;2020-S16;C;165;14;41;8;124;6
76;2020-S16;D;43;4;20;2;23;2
76;2020-S16;E;111;23;28;2;83;21
76;2020-S17;0;599;31;175;11;424;20
76;2020-S17;A;5;0;3;0;2;0
76;2020-S17;B;208;7;49;4;159;3
76;2020-S17;C;164;4;58;2;106;2
76;2020-S17;D;61;7;26;4;35;3
76;2020-S17;E;161;13;39;1;122;12
76;2020-S18;0;495;12;165;6;330;6
76;2020-S18;A;10;0;8;0;2;0
76;2020-S18;B;163;2;52;0;111;2
76;2020-S18;C;123;5;53;4;70;1
76;2020-S18;D;33;0;8;0;25;0
76;2020-S18;E;166;5;44;2;122;3
76;2020-S19;0;673;8;222;4;451;4
76;2020-S19;A;23;0;8;0;15;0
76;2020-S19;B;241;4;69;2;172;2
76;2020-S19;C;183;2;73;1;110;1
76;2020-S19;D;60;0;26;0;34;0
76;2020-S19;E;166;2;46;1;120;1
76;2020-S20;0;1520;14;619;7;901;7
76;2020-S20;A;93;0;55;0;38;0
76;2020-S20;B;630;11;249;6;381;5
76;2020-S20;C;403;2;161;1;242;1
76;2020-S20;D;149;0;75;0;74;0
76;2020-S20;E;238;1;74;0;164;1
76;2020-S21;0;883;18;374;5;509;13
76;2020-S21;A;77;0;40;0;37;0
76;2020-S21;B;344;4;148;2;196;2
76;2020-S21;C;242;2;102;0;140;2
76;2020-S21;D;101;2;47;1;54;1
76;2020-S21;E;116;10;36;2;80;8
77;2020-S11;0;6;2;4;2;2;0
77;2020-S11;A;0;0;0;0;0;0
77;2020-S11;B;4;0;2;0;2;0
77;2020-S11;C;1;1;1;1;0;0
77;2020-S11;D;1;1;1;1;0;0
77;2020-S11;E;0;0;0;0;0;0
77;2020-S12;0;160;51;60;19;100;32
77;2020-S12;A;6;0;4;0;2;0
77;2020-S12;B;65;21;17;8;48;13
77;2020-S12;C;48;18;16;4;32;14
77;2020-S12;D;14;3;5;0;9;3
77;2020-S12;E;27;9;18;7;9;2
77;2020-S13;0;518;204;186;83;332;121
77;2020-S13;A;10;0;8;0;2;0
77;2020-S13;B;206;63;58;14;148;49
77;2020-S13;C;173;73;61;29;112;44
77;2020-S13;D;49;27;31;18;18;9
77;2020-S13;E;79;41;28;22;51;19
77;2020-S14;0;967;360;281;105;686;255
77;2020-S14;A;14;2;4;1;10;1
77;2020-S14;B;414;126;96;24;318;102
77;2020-S14;C;373;141;102;38;271;103
77;2020-S14;D;50;22;30;13;20;9
77;2020-S14;E;116;69;49;29;67;40
77;2020-S15;0;1428;475;391;119;1037;356
77;2020-S15;A;5;0;1;0;4;0
77;2020-S15;B;399;108;117;25;282;83
77;2020-S15;C;386;111;109;30;277;81
77;2020-S15;D;94;29;42;12;52;17
77;2020-S15;E;543;227;122;52;421;175
77;2020-S16;0;1720;350;491;104;1229;246
77;2020-S16;A;10;0;4;0;6;0
77;2020-S16;B;446;79;123;27;323;52
77;2020-S16;C;407;80;129;23;278;57
77;2020-S16;D;130;35;61;16;69;19
77;2020-S16;E;726;156;174;38;552;118
77;2020-S17;0;1763;177;470;43;1293;134
77;2020-S17;A;7;1;5;1;2;0
77;2020-S17;B;610;41;157;7;453;34
77;2020-S17;C;459;43;139;11;320;32
77;2020-S17;D;110;13;49;8;61;5
77;2020-S17;E;576;79;120;16;456;63
77;2020-S18;0;963;43;241;11;722;32
77;2020-S18;A;5;0;2;0;3;0
77;2020-S18;B;265;19;51;3;214;16
77;2020-S18;C;243;14;65;4;178;10
77;2020-S18;D;46;3;26;0;20;3
77;2020-S18;E;403;7;97;4;306;3
77;2020-S19;0;929;29;234;7;695;22
77;2020-S19;A;2;0;1;0;1;0
77;2020-S19;B;224;10;38;1;186;9
77;2020-S19;C;187;2;54;0;133;2
77;2020-S19;D;56;3;35;2;21;1
77;2020-S19;E;460;14;106;4;354;10
77;2020-S20;0;515;27;191;8;324;19
77;2020-S20;A;17;0;10;0;7;0
77;2020-S20;B;182;5;58;1;124;4
77;2020-S20;C;166;5;62;1;104;4
77;2020-S20;D;43;0;20;0;23;0
77;2020-S20;E;107;17;41;6;66;11
77;2020-S21;0;370;17;131;4;239;13
77;2020-S21;A;9;0;6;0;3;0
77;2020-S21;B;151;5;51;1;100;4
77;2020-S21;C;119;0;44;0;75;0
77;2020-S21;D;26;2;7;1;19;1
77;2020-S21;E;65;10;23;2;42;8
78;2020-S11;0;76;16;26;10;50;6
78;2020-S11;A;2;0;1;0;1;0
78;2020-S11;B;40;11;15;7;25;4
78;2020-S11;C;25;4;7;3;18;1
78;2020-S11;D;4;0;1;0;3;0
78;2020-S11;E;5;1;2;0;3;1
78;2020-S12;0;226;76;80;35;146;41
78;2020-S12;A;4;1;2;1;2;0
78;2020-S12;B;60;14;14;5;46;9
78;2020-S12;C;54;15;21;9;33;6
78;2020-S12;D;14;6;4;3;10;3
78;2020-S12;E;56;27;23;12;33;15
78;2020-S13;0;590;237;178;74;412;163
78;2020-S13;A;4;2;3;2;1;0
78;2020-S13;B;205;73;42;11;163;62
78;2020-S13;C;176;68;55;26;121;42
78;2020-S13;D;43;22;26;13;17;9
78;2020-S13;E;126;63;47;21;79;42
78;2020-S14;0;682;239;226;86;456;153
78;2020-S14;A;2;0;0;0;2;0
78;2020-S14;B;237;69;58;15;179;54
78;2020-S14;C;207;71;86;35;121;36
78;2020-S14;D;40;14;19;6;21;8
78;2020-S14;E;190;81;62;30;128;51
78;2020-S15;0;687;222;225;69;462;153
78;2020-S15;A;3;0;3;0;0;0
78;2020-S15;B;268;68;77;15;191;53
78;2020-S15;C;218;63;78;22;140;41
78;2020-S15;D;36;10;20;8;16;2
78;2020-S15;E;162;81;47;24;115;57
78;2020-S16;0;618;163;205;56;413;107
78;2020-S16;A;5;0;3;0;2;0
78;2020-S16;B;185;37;55;13;130;24
78;2020-S16;C;166;45;71;20;95;25
78;2020-S16;D;37;13;16;4;21;9
78;2020-S16;E;223;68;59;19;164;49
78;2020-S17;0;1396;130;338;31;1058;99
78;2020-S17;A;10;2;1;1;9;1
78;2020-S17;B;356;22;85;8;271;14
78;2020-S17;C;324;27;82;9;242;18
78;2020-S17;D;77;10;40;5;37;5
78;2020-S17;E;627;69;130;8;497;61
78;2020-S18;0;776;28;242;12;534;16
78;2020-S18;A;4;1;1;1;3;0
78;2020-S18;B;291;8;80;3;211;5
78;2020-S18;C;246;15;76;5;170;10
78;2020-S18;D;55;2;32;2;23;0
78;2020-S18;E;175;2;51;1;124;1
78;2020-S19;0;664;29;302;11;362;18
78;2020-S19;A;6;0;2;0;4;0
78;2020-S19;B;290;10;130;2;160;8
78;2020-S19;C;264;7;123;5;141;2
78;2020-S19;D;48;3;24;2;24;1
78;2020-S19;E;43;5;18;2;25;3
78;2020-S20;0;1446;40;644;19;802;21
78;2020-S20;A;43;2;24;1;19;1
78;2020-S20;B;675;20;297;11;378;9
78;2020-S20;C;526;9;235;6;291;3
78;2020-S20;D;97;1;45;0;52;1
78;2020-S20;E;103;8;42;1;61;7
78;2020-S21;0;839;22;343;10;496;12
78;2020-S21;A;63;2;35;2;28;0
78;2020-S21;B;370;8;123;0;247;8
78;2020-S21;C;265;7;120;5;145;2
78;2020-S21;D;79;2;42;0;37;2
78;2020-S21;E;62;3;23;3;39;0
79;2020-S11;0;0;0;0;0;0;0
79;2020-S11;A;0;0;0;0;0;0
79;2020-S11;B;0;0;0;0;0;0
79;2020-S11;C;0;0;0;0;0;0
79;2020-S11;D;0;0;0;0;0;0
79;2020-S11;E;0;0;0;0;0;0
79;2020-S12;0;5;0;2;0;3;0
79;2020-S12;A;0;0;0;0;0;0
79;2020-S12;B;0;0;0;0;0;0
79;2020-S12;C;3;0;1;0;2;0
79;2020-S12;D;0;0;0;0;0;0
79;2020-S12;E;2;0;1;0;1;0
79;2020-S13;0;5;0;1;0;4;0
79;2020-S13;A;0;0;0;0;0;0
79;2020-S13;B;0;0;0;0;0;0
79;2020-S13;C;2;0;0;0;2;0
79;2020-S13;D;1;0;1;0;0;0
79;2020-S13;E;2;0;0;0;2;0
79;2020-S14;0;6;2;3;0;3;2
79;2020-S14;A;0;0;0;0;0;0
79;2020-S14;B;3;2;1;0;2;2
79;2020-S14;C;0;0;0;0;0;0
79;2020-S14;D;1;0;1;0;0;0
79;2020-S14;E;2;0;1;0;1;0
79;2020-S15;0;4;2;0;0;4;2
79;2020-S15;A;0;0;0;0;0;0
79;2020-S15;B;4;2;0;0;4;2
79;2020-S15;C;0;0;0;0;0;0
79;2020-S15;D;0;0;0;0;0;0
79;2020-S15;E;0;0;0;0;0;0
79;2020-S16;0;5;1;1;0;4;1
79;2020-S16;A;0;0;0;0;0;0
79;2020-S16;B;1;1;0;0;1;1
79;2020-S16;C;4;0;1;0;3;0
79;2020-S16;D;0;0;0;0;0;0
79;2020-S16;E;0;0;0;0;0;0
79;2020-S17;0;6;0;2;0;4;0
79;2020-S17;A;0;0;0;0;0;0
79;2020-S17;B;2;0;0;0;2;0
79;2020-S17;C;2;0;1;0;1;0
79;2020-S17;D;0;0;0;0;0;0
79;2020-S17;E;2;0;1;0;1;0
79;2020-S18;0;6;0;0;0;6;0
79;2020-S18;A;0;0;0;0;0;0
79;2020-S18;B;1;0;0;0;1;0
79;2020-S18;C;3;0;0;0;3;0
79;2020-S18;D;1;0;0;0;1;0
79;2020-S18;E;1;0;0;0;1;0
79;2020-S19;0;10;0;5;0;5;0
79;2020-S19;A;1;0;0;0;1;0
79;2020-S19;B;2;0;2;0;0;0
79;2020-S19;C;1;0;1;0;0;0
79;2020-S19;D;2;0;1;0;1;0
79;2020-S19;E;4;0;1;0;3;0
79;2020-S20;0;7;0;2;0;5;0
79;2020-S20;A;1;0;1;0;0;0
79;2020-S20;B;3;0;1;0;2;0
79;2020-S20;C;3;0;0;0;3;0
79;2020-S20;D;0;0;0;0;0;0
79;2020-S20;E;0;0;0;0;0;0
79;2020-S21;0;14;0;8;0;6;0
79;2020-S21;A;0;0;0;0;0;0
79;2020-S21;B;6;0;3;0;3;0
79;2020-S21;C;6;0;4;0;2;0
79;2020-S21;D;0;0;0;0;0;0
79;2020-S21;E;2;0;1;0;1;0
80;2020-S11;0;3;1;1;1;2;0
80;2020-S11;A;1;1;1;1;0;0
80;2020-S11;B;1;0;0;0;1;0
80;2020-S11;C;1;0;0;0;1;0
80;2020-S11;D;0;0;0;0;0;0
80;2020-S11;E;0;0;0;0;0;0
80;2020-S12;0;45;21;19;8;26;13
80;2020-S12;A;0;0;0;0;0;0
80;2020-S12;B;8;2;2;0;6;2
80;2020-S12;C;6;2;2;0;4;2
80;2020-S12;D;4;1;2;1;2;0
80;2020-S12;E;26;16;12;7;14;9
80;2020-S13;0;185;67;67;29;118;38
80;2020-S13;A;6;1;5;1;1;0
80;2020-S13;B;56;13;12;4;44;9
80;2020-S13;C;39;16;13;5;26;11
80;2020-S13;D;28;12;16;7;12;5
80;2020-S13;E;56;25;21;12;35;13
80;2020-S14;0;315;102;97;40;218;62
80;2020-S14;A;1;0;0;0;1;0
80;2020-S14;B;119;24;17;4;102;20
80;2020-S14;C;103;31;34;10;69;21
80;2020-S14;D;27;15;15;8;12;7
80;2020-S14;E;65;32;31;18;34;14
80;2020-S15;0;462;105;160;41;302;64
80;2020-S15;A;4;0;0;0;4;0
80;2020-S15;B;186;36;60;14;126;22
80;2020-S15;C;133;32;50;13;83;19
80;2020-S15;D;47;10;18;4;29;6
80;2020-S15;E;92;27;32;10;60;17
80;2020-S16;0;377;64;138;21;239;43
80;2020-S16;A;3;0;0;0;3;0
80;2020-S16;B;152;25;42;5;110;20
80;2020-S16;C;113;16;47;7;66;9
80;2020-S16;D;27;2;15;1;12;1
80;2020-S16;E;82;21;34;8;48;13
80;2020-S17;0;682;57;202;17;480;40
80;2020-S17;A;7;0;4;0;3;0
80;2020-S17;B;189;15;60;2;129;13
80;2020-S17;C;173;15;57;8;116;7
80;2020-S17;D;66;4;32;1;34;3
80;2020-S17;E;246;23;49;6;197;17
80;2020-S18;0;876;55;235;14;641;41
80;2020-S18;A;10;0;6;0;4;0
80;2020-S18;B;287;17;62;6;225;11
80;2020-S18;C;192;8;57;2;135;6
80;2020-S18;D;64;1;31;0;33;1
80;2020-S18;E;323;29;79;6;244;23
80;2020-S19;0;1116;28;317;9;799;19
80;2020-S19;A;13;1;7;1;6;0
80;2020-S19;B;349;6;103;0;246;6
80;2020-S19;C;275;6;82;3;193;3
80;2020-S19;D;86;4;36;1;50;3
80;2020-S19;E;393;11;89;4;304;7
80;2020-S20;0;1075;17;345;5;730;12
80;2020-S20;A;35;0;14;0;21;0
80;2020-S20;B;383;6;131;0;252;6
80;2020-S20;C;276;4;85;3;191;1
80;2020-S20;D;89;0;42;0;47;0
80;2020-S20;E;292;7;73;2;219;5
80;2020-S21;0;776;19;274;6;502;13
80;2020-S21;A;30;0;12;0;18;0
80;2020-S21;B;317;1;108;1;209;0
80;2020-S21;C;212;7;80;3;132;4
80;2020-S21;D;81;1;36;0;45;1
80;2020-S21;E;136;10;38;2;98;8
81;2020-S11;0;0;0;0;0;0;0
81;2020-S11;A;0;0;0;0;0;0
81;2020-S11;B;0;0;0;0;0;0
81;2020-S11;C;0;0;0;0;0;0
81;2020-S11;D;0;0;0;0;0;0
81;2020-S11;E;0;0;0;0;0;0
81;2020-S12;0;22;1;7;0;15;1
81;2020-S12;A;0;0;0;0;0;0
81;2020-S12;B;11;1;4;0;7;1
81;2020-S12;C;5;0;0;0;5;0
81;2020-S12;D;0;0;0;0;0;0
81;2020-S12;E;6;0;3;0;3;0
81;2020-S13;0;77;11;22;2;55;9
81;2020-S13;A;1;0;0;0;1;0
81;2020-S13;B;35;5;8;0;27;5
81;2020-S13;C;23;3;6;0;17;3
81;2020-S13;D;2;1;2;1;0;0
81;2020-S13;E;16;2;6;1;10;1
81;2020-S14;0;105;8;28;3;77;5
81;2020-S14;A;0;0;0;0;0;0
81;2020-S14;B;36;1;5;0;31;1
81;2020-S14;C;32;4;11;2;21;2
81;2020-S14;D;10;0;7;0;3;0
81;2020-S14;E;27;3;5;1;22;2
81;2020-S15;0;133;9;39;1;94;8
81;2020-S15;A;0;0;0;0;0;0
81;2020-S15;B;55;8;11;1;44;7
81;2020-S15;C;46;1;16;0;30;1
81;2020-S15;D;15;0;6;0;9;0
81;2020-S15;E;17;0;6;0;11;0
81;2020-S16;0;172;6;45;3;127;3
81;2020-S16;A;1;0;1;0;0;0
81;2020-S16;B;58;1;11;1;47;0
81;2020-S16;C;58;4;15;1;43;3
81;2020-S16;D;12;0;3;0;9;0
81;2020-S16;E;42;1;14;1;28;0
81;2020-S17;0;274;6;59;1;215;5
81;2020-S17;A;0;0;0;0;0;0
81;2020-S17;B;78;1;15;0;63;1
81;2020-S17;C;70;0;16;0;54;0
81;2020-S17;D;12;0;4;0;8;0
81;2020-S17;E;114;5;24;1;90;4
81;2020-S18;0;167;1;48;0;119;1
81;2020-S18;A;5;0;2;0;3;0
81;2020-S18;B;25;1;13;0;12;1
81;2020-S18;C;13;0;4;0;9;0
81;2020-S18;D;6;0;3;0;3;0
81;2020-S18;E;118;0;26;0;92;0
81;2020-S19;0;45;0;17;0;28;0
81;2020-S19;A;2;0;2;0;0;0
81;2020-S19;B;21;0;9;0;12;0
81;2020-S19;C;10;0;5;0;5;0
81;2020-S19;D;2;0;1;0;1;0
81;2020-S19;E;10;0;0;0;10;0
81;2020-S20;0;625;1;262;1;363;0
81;2020-S20;A;27;0;13;0;14;0
81;2020-S20;B;222;0;93;0;129;0
81;2020-S20;C;209;0;89;0;120;0
81;2020-S20;D;47;0;22;0;25;0
81;2020-S20;E;112;1;43;1;69;0
81;2020-S21;0;382;1;177;1;205;0
81;2020-S21;A;33;0;20;0;13;0
81;2020-S21;B;153;0;73;0;80;0
81;2020-S21;C;102;0;42;0;60;0
81;2020-S21;D;31;0;11;0;20;0
81;2020-S21;E;59;1;28;1;31;0
82;2020-S11;0;9;0;5;0;4;0
82;2020-S11;A;0;0;0;0;0;0
82;2020-S11;B;1;0;1;0;0;0
82;2020-S11;C;4;0;2;0;2;0
82;2020-S11;D;1;0;1;0;0;0
82;2020-S11;E;3;0;1;0;2;0
82;2020-S12;0;96;4;44;2;52;2
82;2020-S12;A;3;0;2;0;1;0
82;2020-S12;B;40;1;13;0;27;1
82;2020-S12;C;28;1;12;1;16;0
82;2020-S12;D;12;2;8;1;4;1
82;2020-S12;E;13;0;9;0;4;0
82;2020-S13;0;189;15;59;8;130;7
82;2020-S13;A;5;0;3;0;2;0
82;2020-S13;B;75;6;10;3;65;3
82;2020-S13;C;61;8;19;5;42;3
82;2020-S13;D;17;1;13;0;4;1
82;2020-S13;E;30;0;14;0;16;0
82;2020-S14;0;197;11;71;8;126;3
82;2020-S14;A;3;0;2;0;1;0
82;2020-S14;B;80;3;24;1;56;2
82;2020-S14;C;76;5;29;4;47;1
82;2020-S14;D;11;1;6;1;5;0
82;2020-S14;E;27;2;10;2;17;0
82;2020-S15;0;353;26;82;5;271;21
82;2020-S15;A;0;0;0;0;0;0
82;2020-S15;B;106;5;14;0;92;5
82;2020-S15;C;106;3;24;0;82;3
82;2020-S15;D;22;3;15;2;7;1
82;2020-S15;E;118;15;29;3;89;12
82;2020-S16;0;109;5;31;1;78;4
82;2020-S16;A;1;0;1;0;0;0
82;2020-S16;B;36;2;11;1;25;1
82;2020-S16;C;38;3;14;0;24;3
82;2020-S16;D;9;0;2;0;7;0
82;2020-S16;E;25;0;3;0;22;0
82;2020-S17;0;162;6;45;1;117;5
82;2020-S17;A;0;0;0;0;0;0
82;2020-S17;B;63;1;13;0;50;1
82;2020-S17;C;62;3;18;1;44;2
82;2020-S17;D;13;1;6;0;7;1
82;2020-S17;E;24;1;8;0;16;1
82;2020-S18;0;76;3;23;1;53;2
82;2020-S18;A;1;0;0;0;1;0
82;2020-S18;B;41;1;11;0;30;1
82;2020-S18;C;24;1;10;1;14;0
82;2020-S18;D;6;1;1;0;5;1
82;2020-S18;E;4;0;1;0;3;0
82;2020-S19;0;94;1;41;0;53;1
82;2020-S19;A;9;0;5;0;4;0
82;2020-S19;B;36;1;17;0;19;1
82;2020-S19;C;33;0;11;0;22;0
82;2020-S19;D;9;0;5;0;4;0
82;2020-S19;E;7;0;3;0;4;0
82;2020-S20;0;380;1;148;1;232;0
82;2020-S20;A;27;0;13;0;14;0
82;2020-S20;B;143;0;45;0;98;0
82;2020-S20;C;131;1;50;1;81;0
82;2020-S20;D;44;0;21;0;23;0
82;2020-S20;E;23;0;7;0;16;0
82;2020-S21;0;386;0;132;0;254;0
82;2020-S21;A;26;0;12;0;14;0
82;2020-S21;B;136;0;47;0;89;0
82;2020-S21;C;115;0;34;0;81;0
82;2020-S21;D;28;0;15;0;13;0
82;2020-S21;E;81;0;24;0;57;0
83;2020-S11;0;14;1;6;1;8;0
83;2020-S11;A;0;0;0;0;0;0
83;2020-S11;B;5;0;1;0;4;0
83;2020-S11;C;5;0;2;0;3;0
83;2020-S11;D;1;0;1;0;0;0
83;2020-S11;E;3;1;2;1;1;0
83;2020-S12;0;167;22;72;11;95;11
83;2020-S12;A;4;0;1;0;3;0
83;2020-S12;B;58;6;24;2;34;4
83;2020-S12;C;46;11;20;6;26;5
83;2020-S12;D;16;1;10;1;6;0
83;2020-S12;E;41;4;16;2;25;2
83;2020-S13;0;621;105;226;55;395;50
83;2020-S13;A;7;0;3;0;4;0
83;2020-S13;B;233;28;73;13;160;15
83;2020-S13;C;203;36;78;20;125;16
83;2020-S13;D;71;21;35;12;36;9
83;2020-S13;E;81;18;29;9;52;9
83;2020-S14;0;758;106;279;40;479;66
83;2020-S14;A;5;0;4;0;1;0
83;2020-S14;B;263;19;80;6;183;13
83;2020-S14;C;271;40;108;17;163;23
83;2020-S14;D;86;12;37;6;49;6
83;2020-S14;E;133;35;50;11;83;24
83;2020-S15;0;1284;99;352;29;932;70
83;2020-S15;A;10;0;6;0;4;0
83;2020-S15;B;429;24;116;8;313;16
83;2020-S15;C;371;31;108;11;263;20
83;2020-S15;D;71;7;29;3;42;4
83;2020-S15;E;399;37;91;7;308;30
83;2020-S16;0;2581;52;657;15;1924;37
83;2020-S16;A;20;0;7;0;13;0
83;2020-S16;B;623;8;142;3;481;5
83;2020-S16;C;641;20;171;5;470;15
83;2020-S16;D;136;0;64;0;72;0
83;2020-S16;E;1151;24;270;7;881;17
83;2020-S17;0;1742;22;522;9;1220;13
83;2020-S17;A;36;2;14;1;22;1
83;2020-S17;B;454;8;139;4;315;4
83;2020-S17;C;440;4;139;2;301;2
83;2020-S17;D;130;1;60;1;70;0
83;2020-S17;E;674;7;168;1;506;6
83;2020-S18;0;626;10;203;3;423;7
83;2020-S18;A;16;0;3;0;13;0
83;2020-S18;B;180;2;57;1;123;1
83;2020-S18;C;194;4;64;1;130;3
83;2020-S18;D;43;0;20;0;23;0
83;2020-S18;E;192;4;58;1;134;3
83;2020-S19;0;1167;26;335;6;832;20
83;2020-S19;A;12;0;2;0;10;0
83;2020-S19;B;330;4;111;1;219;3
83;2020-S19;C;337;7;87;2;250;5
83;2020-S19;D;84;1;32;0;52;1
83;2020-S19;E;399;14;101;3;298;11
83;2020-S20;0;895;10;311;4;583;6
83;2020-S20;A;35;0;22;0;12;0
83;2020-S20;B;297;2;89;2;208;0
83;2020-S20;C;280;5;94;2;186;3
83;2020-S20;D;124;0;49;0;75;0
83;2020-S20;E;158;3;56;0;102;3
83;2020-S21;0;1022;11;343;3;679;8
83;2020-S21;A;51;0;21;0;30;0
83;2020-S21;B;279;0;87;0;192;0
83;2020-S21;C;293;0;100;0;193;0
83;2020-S21;D;86;1;39;1;47;0
83;2020-S21;E;304;10;91;2;213;8
84;2020-S11;0;7;0;4;0;3;0
84;2020-S11;A;0;0;0;0;0;0
84;2020-S11;B;2;0;1;0;1;0
84;2020-S11;C;2;0;1;0;1;0
84;2020-S11;D;0;0;0;0;0;0
84;2020-S11;E;3;0;2;0;1;0
84;2020-S12;0;48;11;12;3;36;8
84;2020-S12;A;2;0;1;0;1;0
84;2020-S12;B;19;3;4;0;15;3
84;2020-S12;C;15;3;3;0;12;3
84;2020-S12;D;6;4;3;3;3;1
84;2020-S12;E;4;0;1;0;3;0
84;2020-S13;0;414;53;152;23;262;30
84;2020-S13;A;3;0;2;0;1;0
84;2020-S13;B;168;14;61;4;107;10
84;2020-S13;C;135;26;42;9;93;17
84;2020-S13;D;34;8;18;6;16;2
84;2020-S13;E;73;5;29;4;44;1
84;2020-S14;0;712;50;236;27;468;23
84;2020-S14;A;12;0;1;0;4;0
84;2020-S14;B;293;11;91;7;201;4
84;2020-S14;C;266;29;87;17;179;12
84;2020-S14;D;60;5;26;2;34;3
84;2020-S14;E;81;5;31;1;50;4
84;2020-S15;0;977;52;274;14;697;38
84;2020-S15;A;6;0;2;0;1;0
84;2020-S15;B;270;8;80;3;188;5
84;2020-S15;C;287;13;85;4;201;9
84;2020-S15;D;63;3;21;1;42;2
84;2020-S15;E;349;28;85;6;264;22
84;2020-S16;0;1695;26;418;12;1277;14
84;2020-S16;A;12;0;5;0;7;0
84;2020-S16;B;484;6;127;6;357;0
84;2020-S16;C;533;6;125;2;408;4
84;2020-S16;D;112;4;47;3;65;1
84;2020-S16;E;549;10;112;1;437;9
84;2020-S17;0;990;6;286;1;704;5
84;2020-S17;A;11;0;4;0;7;0
84;2020-S17;B;281;2;80;0;201;2
84;2020-S17;C;261;3;81;1;180;2
84;2020-S17;D;83;0;34;0;49;0
84;2020-S17;E;352;1;85;0;267;1
84;2020-S18;0;596;5;182;3;414;2
84;2020-S18;A;15;0;8;0;7;0
84;2020-S18;B;176;1;49;1;127;0
84;2020-S18;C;186;2;55;1;131;1
84;2020-S18;D;41;1;21;1;20;0
84;2020-S18;E;178;1;49;0;129;1
84;2020-S19;0;827;5;295;2;532;3
84;2020-S19;A;23;0;11;0;12;0
84;2020-S19;B;255;0;105;0;150;0
84;2020-S19;C;278;1;100;0;178;1
84;2020-S19;D;68;1;30;1;38;0
84;2020-S19;E;202;3;49;1;153;2
84;2020-S20;0;816;4;364;3;452;1
84;2020-S20;A;51;0;34;0;17;0
84;2020-S20;B;292;2;137;1;155;1
84;2020-S20;C;238;1;100;1;138;0
84;2020-S20;D;91;0;42;0;49;0
84;2020-S20;E;144;1;51;1;93;0
84;2020-S21;0;792;4;413;4;378;0
84;2020-S21;A;45;0;28;0;17;0
84;2020-S21;B;306;1;149;1;156;0
84;2020-S21;C;280;3;167;3;113;0
84;2020-S21;D;66;0;30;0;36;0
84;2020-S21;E;94;0;39;0;55;0
85;2020-S11;0;0;0;0;0;0;0
85;2020-S11;A;0;0;0;0;0;0
85;2020-S11;B;0;0;0;0;0;0
85;2020-S11;C;0;0;0;0;0;0
85;2020-S11;D;0;0;0;0;0;0
85;2020-S11;E;0;0;0;0;0;0
85;2020-S12;0;5;1;2;0;3;1
85;2020-S12;A;0;0;0;0;0;0
85;2020-S12;B;0;0;0;0;0;0
85;2020-S12;C;3;1;1;0;2;1
85;2020-S12;D;0;0;0;0;0;0
85;2020-S12;E;2;0;1;0;1;0
85;2020-S13;0;51;5;20;3;31;2
85;2020-S13;A;0;0;0;0;0;0
85;2020-S13;B;9;0;0;0;9;0
85;2020-S13;C;17;3;6;1;11;2
85;2020-S13;D;9;0;6;0;3;0
85;2020-S13;E;16;2;8;2;8;0
85;2020-S14;0;18;2;0;0;18;2
85;2020-S14;A;0;0;0;0;0;0
85;2020-S14;B;11;1;0;0;11;1
85;2020-S14;C;2;0;0;0;2;0
85;2020-S14;D;0;0;0;0;0;0
85;2020-S14;E;5;1;0;0;5;1
85;2020-S15;0;16;0;4;0;12;0
85;2020-S15;A;0;0;0;0;0;0
85;2020-S15;B;8;0;1;0;7;0
85;2020-S15;C;5;0;3;0;2;0
85;2020-S15;D;1;0;0;0;1;0
85;2020-S15;E;2;0;0;0;2;0
85;2020-S16;0;19;0;4;0;15;0
85;2020-S16;A;1;0;0;0;1;0
85;2020-S16;B;9;0;3;0;6;0
85;2020-S16;C;5;0;1;0;4;0
85;2020-S16;D;2;0;0;0;2;0
85;2020-S16;E;2;0;0;0;2;0
85;2020-S17;0;26;0;6;0;20;0
85;2020-S17;A;0;0;0;0;0;0
85;2020-S17;B;9;0;3;0;6;0
85;2020-S17;C;5;0;0;0;5;0
85;2020-S17;D;5;0;1;0;4;0
85;2020-S17;E;7;0;2;0;5;0
85;2020-S18;0;32;1;12;0;20;1
85;2020-S18;A;1;0;1;0;0;0
85;2020-S18;B;13;0;4;0;9;0
85;2020-S18;C;10;0;3;0;7;0
85;2020-S18;D;5;0;2;0;3;0
85;2020-S18;E;3;1;2;0;1;1
85;2020-S19;0;31;0;15;0;16;0
85;2020-S19;A;2;0;2;0;0;0
85;2020-S19;B;11;0;3;0;8;0
85;2020-S19;C;7;0;4;0;3;0
85;2020-S19;D;8;0;5;0;3;0
85;2020-S19;E;3;0;1;0;2;0
85;2020-S20;0;28;0;13;0;15;0
85;2020-S20;A;1;0;0;0;1;0
85;2020-S20;B;10;0;7;0;3;0
85;2020-S20;C;10;0;3;0;7;0
85;2020-S20;D;2;0;1;0;1;0
85;2020-S20;E;4;0;2;0;2;0
85;2020-S21;0;95;0;44;0;51;0
85;2020-S21;A;12;0;7;0;5;0
85;2020-S21;B;35;0;17;0;18;0
85;2020-S21;C;19;0;8;0;11;0
85;2020-S21;D;18;0;7;0;11;0
85;2020-S21;E;11;0;5;0;6;0
86;2020-S11;0;2;0;0;0;2;0
86;2020-S11;A;1;0;0;0;1;0
86;2020-S11;B;0;0;0;0;0;0
86;2020-S11;C;0;0;0;0;0;0
86;2020-S11;D;0;0;0;0;0;0
86;2020-S11;E;1;0;0;0;1;0
86;2020-S12;0;7;2;3;1;4;1
86;2020-S12;A;0;0;0;0;0;0
86;2020-S12;B;2;1;1;1;1;0
86;2020-S12;C;4;1;2;0;2;1
86;2020-S12;D;0;0;0;0;0;0
86;2020-S12;E;1;0;0;0;1;0
86;2020-S13;0;24;5;5;3;19;2
86;2020-S13;A;0;0;0;0;0;0
86;2020-S13;B;10;4;2;2;8;2
86;2020-S13;C;4;0;0;0;4;0
86;2020-S13;D;2;0;1;0;1;0
86;2020-S13;E;8;1;2;1;6;0
86;2020-S14;0;21;5;6;2;15;3
86;2020-S14;A;0;0;0;0;0;0
86;2020-S14;B;4;1;2;1;2;0
86;2020-S14;C;5;1;1;0;4;1
86;2020-S14;D;0;0;0;0;0;0
86;2020-S14;E;12;3;3;1;9;2
86;2020-S15;0;38;4;18;1;20;3
86;2020-S15;A;1;0;1;0;0;0
86;2020-S15;B;17;2;10;1;7;1
86;2020-S15;C;7;0;2;0;5;0
86;2020-S15;D;2;1;0;0;2;1
86;2020-S15;E;11;1;5;0;6;1
86;2020-S16;0;23;2;11;1;12;1
86;2020-S16;A;0;0;0;0;0;0
86;2020-S16;B;12;1;7;0;5;1
86;2020-S16;C;5;1;3;1;2;0
86;2020-S16;D;2;0;1;0;1;0
86;2020-S16;E;4;0;0;0;4;0
86;2020-S17;0;42;4;15;3;27;1
86;2020-S17;A;0;0;0;0;0;0
86;2020-S17;B;5;2;3;1;2;1
86;2020-S17;C;12;1;3;1;9;0
86;2020-S17;D;7;0;4;0;3;0
86;2020-S17;E;18;1;5;1;13;0
86;2020-S18;0;39;2;8;1;31;1
86;2020-S18;A;0;0;0;0;0;0
86;2020-S18;B;18;0;4;0;14;0
86;2020-S18;C;12;0;0;0;12;0
86;2020-S18;D;2;0;1;0;1;0
86;2020-S18;E;7;2;3;1;4;1
86;2020-S19;0;244;2;71;1;173;1
86;2020-S19;A;4;0;1;0;3;0
86;2020-S19;B;55;0;15;0;40;0
86;2020-S19;C;55;0;12;0;43;0
86;2020-S19;D;23;1;16;1;7;0
86;2020-S19;E;106;1;26;0;80;1
86;2020-S20;0;593;1;148;0;445;1
86;2020-S20;A;6;0;2;0;4;0
86;2020-S20;B;155;1;33;0;122;1
86;2020-S20;C;126;0;27;0;99;0
86;2020-S20;D;33;0;18;0;15;0
86;2020-S20;E;273;0;68;0;205;0
86;2020-S21;0;49;1;25;0;24;1
86;2020-S21;A;2;0;1;0;1;0
86;2020-S21;B;11;0;5;0;6;0
86;2020-S21;C;19;0;7;0;12;0
86;2020-S21;D;5;0;4;0;1;0
86;2020-S21;E;12;1;8;0;4;1
87;2020-S11;0;1;0;1;0;0;0
87;2020-S11;A;0;0;0;0;0;0
87;2020-S11;B;0;0;0;0;0;0
87;2020-S11;C;1;0;1;0;0;0
87;2020-S11;D;0;0;0;0;0;0
87;2020-S11;E;0;0;0;0;0;0
87;2020-S12;0;6;2;3;1;3;1
87;2020-S12;A;0;0;0;0;0;0
87;2020-S12;B;1;0;0;0;1;0
87;2020-S12;C;2;1;1;1;1;0
87;2020-S12;D;2;1;1;0;1;1
87;2020-S12;E;1;0;1;0;0;0
87;2020-S13;0;76;15;23;8;51;7
87;2020-S13;A;1;0;0;0;1;0
87;2020-S13;B;29;3;10;2;17;1
87;2020-S13;C;21;3;5;1;16;2
87;2020-S13;D;12;7;5;4;7;3
87;2020-S13;E;13;2;3;1;10;1
87;2020-S14;0;95;11;26;2;68;9
87;2020-S14;A;0;0;0;0;0;0
87;2020-S14;B;35;3;9;0;25;3
87;2020-S14;C;36;3;9;1;27;2
87;2020-S14;D;5;0;3;0;2;0
87;2020-S14;E;19;5;5;1;14;4
87;2020-S15;0;147;16;41;1;103;15
87;2020-S15;A;1;0;0;0;1;0
87;2020-S15;B;54;5;14;0;37;5
87;2020-S15;C;67;5;19;0;48;5
87;2020-S15;D;12;1;4;1;8;0
87;2020-S15;E;13;5;4;0;9;5
87;2020-S16;0;198;5;55;1;140;4
87;2020-S16;A;0;0;0;0;0;0
87;2020-S16;B;64;1;17;0;44;1
87;2020-S16;C;67;1;20;0;47;1
87;2020-S16;D;11;0;6;0;5;0
87;2020-S16;E;56;3;12;1;44;2
87;2020-S17;0;303;11;90;4;210;7
87;2020-S17;A;2;0;1;0;1;0
87;2020-S17;B;50;2;17;1;30;1
87;2020-S17;C;32;3;11;1;21;2
87;2020-S17;D;23;0;6;0;17;0
87;2020-S17;E;196;6;55;2;141;4
87;2020-S18;0;73;2;28;1;45;1
87;2020-S18;A;4;0;1;0;3;0
87;2020-S18;B;22;1;9;0;13;1
87;2020-S18;C;27;0;8;0;19;0
87;2020-S18;D;7;0;2;0;5;0
87;2020-S18;E;13;1;8;1;5;0
87;2020-S19;0;226;5;81;0;141;5
87;2020-S19;A;8;0;5;0;3;0
87;2020-S19;B;82;0;33;0;45;0
87;2020-S19;C;70;2;23;0;47;2
87;2020-S19;D;8;0;3;0;5;0
87;2020-S19;E;56;3;16;0;40;3
87;2020-S20;0;273;0;141;0;126;0
87;2020-S20;A;12;0;7;0;4;0
87;2020-S20;B;150;0;89;0;57;0
87;2020-S20;C;69;0;28;0;41;0
87;2020-S20;D;21;0;8;0;12;0
87;2020-S20;E;21;0;9;0;12;0
87;2020-S21;0;170;0;74;0;93;0
87;2020-S21;A;16;0;10;0;6;0
87;2020-S21;B;67;0;29;0;35;0
87;2020-S21;C;50;0;19;0;31;0
87;2020-S21;D;17;0;4;0;13;0
87;2020-S21;E;18;0;10;0;8;0
88;2020-S11;0;0;0;0;0;0;0
88;2020-S11;A;0;0;0;0;0;0
88;2020-S11;B;0;0;0;0;0;0
88;2020-S11;C;0;0;0;0;0;0
88;2020-S11;D;0;0;0;0;0;0
88;2020-S11;E;0;0;0;0;0;0
88;2020-S12;0;22;9;5;3;17;6
88;2020-S12;A;0;0;0;0;0;0
88;2020-S12;B;13;3;2;1;11;2
88;2020-S12;C;5;4;1;1;4;3
88;2020-S12;D;1;0;1;0;0;0
88;2020-S12;E;3;2;1;1;2;1
88;2020-S13;0;250;97;64;26;186;71
88;2020-S13;A;2;0;1;0;1;0
88;2020-S13;B;114;39;22;6;92;33
88;2020-S13;C;87;39;22;10;65;29
88;2020-S13;D;16;6;9;5;7;1
88;2020-S13;E;30;13;9;5;21;8
88;2020-S14;0;360;134;79;30;281;104
88;2020-S14;A;2;0;1;0;1;0
88;2020-S14;B;138;45;23;5;115;40
88;2020-S14;C;140;58;27;12;113;46
88;2020-S14;D;26;5;11;2;15;3
88;2020-S14;E;53;26;17;11;36;15
88;2020-S15;0;331;95;84;20;247;75
88;2020-S15;A;2;0;1;0;1;0
88;2020-S15;B;142;37;24;3;118;34
88;2020-S15;C;114;39;22;7;92;32
88;2020-S15;D;23;4;12;2;11;2
88;2020-S15;E;50;15;25;8;25;7
88;2020-S16;0;188;32;58;7;130;25
88;2020-S16;A;0;0;0;0;0;0
88;2020-S16;B;66;14;15;3;51;11
88;2020-S16;C;65;14;25;3;40;11
88;2020-S16;D;31;0;11;0;20;0
88;2020-S16;E;25;4;7;1;18;3
88;2020-S17;0;23;1;9;1;14;0
88;2020-S17;A;1;0;1;0;0;0
88;2020-S17;B;10;1;3;1;7;0
88;2020-S17;C;11;0;4;0;7;0
88;2020-S17;D;0;0;0;0;0;0
88;2020-S17;E;1;0;1;0;0;0
88;2020-S18;0;54;1;20;1;34;0
88;2020-S18;A;3;0;1;0;2;0
88;2020-S18;B;25;0;8;0;17;0
88;2020-S18;C;12;1;6;1;6;0
88;2020-S18;D;9;0;4;0;5;0
88;2020-S18;E;4;0;0;0;4;0
88;2020-S19;0;756;11;243;6;513;5
88;2020-S19;A;13;0;10;0;3;0
88;2020-S19;B;237;2;77;1;160;1
88;2020-S19;C;241;6;81;3;160;3
88;2020-S19;D;80;1;39;1;41;0
88;2020-S19;E;185;2;36;1;149;1
88;2020-S20;0;368;9;143;4;225;5
88;2020-S20;A;11;0;3;0;8;0
88;2020-S20;B;108;2;44;1;64;1
88;2020-S20;C;111;1;51;1;60;0
88;2020-S20;D;32;1;18;0;14;1
88;2020-S20;E;106;5;27;2;79;3
88;2020-S21;0;548;9;240;3;308;6
88;2020-S21;A;36;0;23;0;13;0
88;2020-S21;B;176;3;68;1;108;2
88;2020-S21;C;183;0;77;0;106;0
88;2020-S21;D;79;1;42;1;37;0
88;2020-S21;E;74;5;30;1;44;4
89;2020-S11;0;1;0;1;0;0;0
89;2020-S11;A;0;0;0;0;0;0
89;2020-S11;B;0;0;0;0;0;0
89;2020-S11;C;0;0;0;0;0;0
89;2020-S11;D;1;0;1;0;0;0
89;2020-S11;E;0;0;0;0;0;0
89;2020-S12;0;78;8;22;3;56;5
89;2020-S12;A;5;0;2;0;3;0
89;2020-S12;B;35;3;5;1;30;2
89;2020-S12;C;18;3;6;2;12;1
89;2020-S12;D;6;1;4;0;2;1
89;2020-S12;E;14;1;5;0;9;1
89;2020-S13;0;58;10;15;1;43;9
89;2020-S13;A;1;0;0;0;1;0
89;2020-S13;B;29;7;3;0;26;7
89;2020-S13;C;14;1;5;0;9;1
89;2020-S13;D;3;0;1;0;2;0
89;2020-S13;E;11;2;6;1;5;1
89;2020-S14;0;42;7;11;3;31;4
89;2020-S14;A;1;0;0;0;1;0
89;2020-S14;B;24;1;5;0;19;1
89;2020-S14;C;11;4;3;2;8;2
89;2020-S14;D;2;0;2;0;0;0
89;2020-S14;E;4;2;1;1;3;1
89;2020-S15;0;41;10;14;3;27;7
89;2020-S15;A;0;0;0;0;0;0
89;2020-S15;B;11;2;3;0;8;2
89;2020-S15;C;14;4;6;2;8;2
89;2020-S15;D;3;0;0;0;3;0
89;2020-S15;E;13;4;5;1;8;3
89;2020-S16;0;100;13;14;3;86;10
89;2020-S16;A;0;0;0;0;0;0
89;2020-S16;B;43;5;6;1;37;4
89;2020-S16;C;38;6;3;0;35;6
89;2020-S16;D;4;1;2;1;2;0
89;2020-S16;E;14;1;3;1;11;0
89;2020-S17;0;152;5;34;1;118;4
89;2020-S17;A;1;0;1;0;0;0
89;2020-S17;B;25;0;4;0;21;0
89;2020-S17;C;37;2;8;1;29;1
89;2020-S17;D;9;1;4;0;5;1
89;2020-S17;E;80;2;17;0;63;2
89;2020-S18;0;44;2;10;0;34;2
89;2020-S18;A;0;0;0;0;0;0
89;2020-S18;B;19;2;6;0;13;2
89;2020-S18;C;19;0;2;0;17;0
89;2020-S18;D;1;0;1;0;0;0
89;2020-S18;E;5;0;1;0;4;0
89;2020-S19;0;44;1;15;0;29;1
89;2020-S19;A;1;0;1;0;0;0
89;2020-S19;B;20;0;7;0;13;0
89;2020-S19;C;8;1;1;0;7;1
89;2020-S19;D;4;0;2;0;2;0
89;2020-S19;E;10;0;4;0;6;0
89;2020-S20;0;54;6;25;1;29;5
89;2020-S20;A;1;0;1;0;0;0
89;2020-S20;B;11;1;4;0;7;1
89;2020-S20;C;23;5;10;1;13;4
89;2020-S20;D;10;0;7;0;3;0
89;2020-S20;E;9;0;3;0;6;0
89;2020-S21;0;13;0;6;0;7;0
89;2020-S21;A;1;0;1;0;0;0
89;2020-S21;B;5;0;3;0;2;0
89;2020-S21;C;4;0;1;0;3;0
89;2020-S21;D;2;0;1;0;1;0
89;2020-S21;E;1;0;0;0;1;0
90;2020-S11;0;0;0;0;0;0;0
90;2020-S11;A;0;0;0;0;0;0
90;2020-S11;B;0;0;0;0;0;0
90;2020-S11;C;0;0;0;0;0;0
90;2020-S11;D;0;0;0;0;0;0
90;2020-S11;E;0;0;0;0;0;0
90;2020-S12;0;12;3;2;0;10;3
90;2020-S12;A;0;0;0;0;0;0
90;2020-S12;B;8;1;1;0;7;1
90;2020-S12;C;3;2;0;0;3;2
90;2020-S12;D;1;0;1;0;0;0
90;2020-S12;E;0;0;0;0;0;0
90;2020-S13;0;85;24;25;4;60;20
90;2020-S13;A;0;0;0;0;0;0
90;2020-S13;B;36;7;7;1;29;6
90;2020-S13;C;39;13;13;2;26;11
90;2020-S13;D;7;3;4;1;3;2
90;2020-S13;E;3;1;1;0;2;1
90;2020-S14;0;167;31;45;4;122;27
90;2020-S14;A;1;0;1;0;0;0
90;2020-S14;B;80;14;12;0;68;14
90;2020-S14;C;63;10;20;0;43;10
90;2020-S14;D;13;4;8;3;5;1
90;2020-S14;E;10;3;4;1;6;2
90;2020-S15;0;120;30;36;10;84;20
90;2020-S15;A;1;0;0;0;1;0
90;2020-S15;B;52;13;10;1;42;12
90;2020-S15;C;41;15;15;8;26;7
90;2020-S15;D;21;2;7;1;14;1
90;2020-S15;E;5;0;4;0;1;0
90;2020-S16;0;68;6;21;4;47;2
90;2020-S16;A;1;0;0;0;1;0
90;2020-S16;B;29;2;7;1;22;1
90;2020-S16;C;24;2;7;1;17;1
90;2020-S16;D;11;1;5;1;6;0
90;2020-S16;E;3;1;2;1;1;0
90;2020-S17;0;70;11;20;3;50;8
90;2020-S17;A;1;0;0;0;1;0
90;2020-S17;B;26;2;9;0;17;2
90;2020-S17;C;11;1;1;0;10;1
90;2020-S17;D;9;2;5;1;4;1
90;2020-S17;E;23;6;5;2;18;4
90;2020-S18;0;17;0;7;0;10;0
90;2020-S18;A;0;0;0;0;0;0
90;2020-S18;B;5;0;3;0;2;0
90;2020-S18;C;9;0;3;0;6;0
90;2020-S18;D;0;0;0;0;0;0
90;2020-S18;E;3;0;1;0;2;0
90;2020-S19;0;43;0;20;0;23;0
90;2020-S19;A;2;0;1;0;1;0
90;2020-S19;B;16;0;6;0;10;0
90;2020-S19;C;17;0;8;0;9;0
90;2020-S19;D;4;0;3;0;1;0
90;2020-S19;E;4;0;2;0;2;0
90;2020-S20;0;177;3;71;1;106;2
90;2020-S20;A;12;1;7;1;5;0
90;2020-S20;B;67;1;29;0;38;1
90;2020-S20;C;73;1;28;0;45;1
90;2020-S20;D;13;0;5;0;8;0
90;2020-S20;E;12;0;2;0;10;0
90;2020-S21;0;90;0;40;0;50;0
90;2020-S21;A;8;0;4;0;4;0
90;2020-S21;B;41;0;19;0;22;0
90;2020-S21;C;21;0;7;0;14;0
90;2020-S21;D;13;0;7;0;6;0
90;2020-S21;E;7;0;3;0;4;0
91;2020-S11;0;69;21;27;9;42;12
91;2020-S11;A;3;1;3;1;0;0
91;2020-S11;B;31;9;12;5;19;4
91;2020-S11;C;19;8;6;2;13;6
91;2020-S11;D;5;0;2;0;3;0
91;2020-S11;E;11;3;4;1;7;2
91;2020-S12;0;362;177;154;90;208;87
91;2020-S12;A;22;1;12;1;10;0
91;2020-S12;B;127;50;33;18;94;32
91;2020-S12;C;102;66;49;38;53;28
91;2020-S12;D;39;26;25;16;14;10
91;2020-S12;E;72;34;35;17;37;17
91;2020-S13;0;854;411;365;198;489;213
91;2020-S13;A;14;4;9;3;5;1
91;2020-S13;B;287;108;96;43;191;65
91;2020-S13;C;303;159;140;83;163;76
91;2020-S13;D;82;49;47;30;35;19
91;2020-S13;E;166;91;72;39;94;52
91;2020-S14;0;846;371;246;130;600;241
91;2020-S14;A;9;1;2;1;7;0
91;2020-S14;B;318;97;69;22;249;75
91;2020-S14;C;239;119;87;49;152;70
91;2020-S14;D;62;32;28;15;34;17
91;2020-S14;E;218;122;60;43;158;79
91;2020-S15;0;1391;538;387;154;1004;384
91;2020-S15;A;9;0;5;0;4;0
91;2020-S15;B;276;95;73;27;203;68
91;2020-S15;C;276;103;78;32;198;71
91;2020-S15;D;96;39;42;12;54;27
91;2020-S15;E;732;300;188;82;544;218
91;2020-S16;0;1690;273;371;59;1319;214
91;2020-S16;A;9;0;4;0;5;0
91;2020-S16;B;330;51;70;14;260;37
91;2020-S16;C;284;38;63;10;221;28
91;2020-S16;D;84;15;29;5;55;10
91;2020-S16;E;981;168;205;30;776;138
91;2020-S17;0;2562;312;606;64;1956;248
91;2020-S17;A;11;0;8;0;3;0
91;2020-S17;B;504;53;96;10;408;43
91;2020-S17;C;458;48;111;16;347;32
91;2020-S17;D;148;22;61;8;87;14
91;2020-S17;E;1427;180;328;28;1099;152
91;2020-S18;0;1551;110;379;22;1172;88
91;2020-S18;A;8;0;5;0;3;0
91;2020-S18;B;432;25;94;5;338;20
91;2020-S18;C;408;25;97;3;311;22
91;2020-S18;D;58;5;26;1;32;4
91;2020-S18;E;636;54;154;13;482;41
91;2020-S19;0;1006;47;239;16;767;31
91;2020-S19;A;13;0;8;0;5;0
91;2020-S19;B;316;8;74;4;242;4
91;2020-S19;C;258;6;64;2;194;4
91;2020-S19;D;24;3;13;3;11;0
91;2020-S19;E;341;28;72;7;269;21
91;2020-S20;0;1501;65;575;18;926;47
91;2020-S20;A;71;2;35;1;36;1
91;2020-S20;B;564;11;216;4;348;7
91;2020-S20;C;461;10;175;4;286;6
91;2020-S20;D;114;4;56;1;58;3
91;2020-S20;E;290;38;93;8;197;30
91;2020-S21;0;1053;26;420;12;633;14
91;2020-S21;A;55;0;23;0;32;0
91;2020-S21;B;369;5;149;2;220;3
91;2020-S21;C;292;2;121;2;171;0
91;2020-S21;D;95;5;49;5;46;0
91;2020-S21;E;242;14;78;3;164;11
92;2020-S11;0;75;23;29;9;46;14
92;2020-S11;A;0;0;0;0;0;0
92;2020-S11;B;25;10;7;4;18;6
92;2020-S11;C;29;7;11;3;18;4
92;2020-S11;D;9;2;6;1;3;1
92;2020-S11;E;12;4;5;1;7;3
92;2020-S12;0;433;184;162;85;271;99
92;2020-S12;A;3;0;0;0;3;0
92;2020-S12;B;156;55;40;18;116;37
92;2020-S12;C;162;68;64;33;98;35
92;2020-S12;D;40;21;24;14;16;7
92;2020-S12;E;72;40;34;20;38;20
92;2020-S13;0;1607;691;568;294;1039;397
92;2020-S13;A;14;0;6;0;8;0
92;2020-S13;B;588;191;161;61;427;130
92;2020-S13;C;550;240;206;105;344;135
92;2020-S13;D;141;73;83;50;58;23
92;2020-S13;E;312;185;110;76;202;109
92;2020-S14;0;1997;723;667;270;1330;453
92;2020-S14;A;8;2;4;1;4;1
92;2020-S14;B;616;168;188;53;428;115
92;2020-S14;C;572;185;188;65;384;120
92;2020-S14;D;174;85;102;56;72;29
92;2020-S14;E;622;280;185;95;437;185
92;2020-S15;0;1809;515;550;142;1259;373
92;2020-S15;A;9;1;4;0;5;1
92;2020-S15;B;442;106;143;27;299;79
92;2020-S15;C;457;125;166;46;291;79
92;2020-S15;D;132;39;63;15;69;24
92;2020-S15;E;769;244;174;54;595;190
92;2020-S16;0;1423;310;444;80;979;230
92;2020-S16;A;6;0;3;0;3;0
92;2020-S16;B;318;46;103;13;215;33
92;2020-S16;C;324;55;94;19;230;36
92;2020-S16;D;160;28;89;11;71;17
92;2020-S16;E;612;179;155;37;457;142
92;2020-S17;0;789;101;312;43;477;58
92;2020-S17;A;6;1;5;1;1;0
92;2020-S17;B;274;26;86;12;188;14
92;2020-S17;C;296;44;123;15;173;29
92;2020-S17;D;98;11;48;6;50;5
92;2020-S17;E;112;19;49;9;63;10
92;2020-S18;0;693;45;277;20;416;25
92;2020-S18;A;5;0;2;0;3;0
92;2020-S18;B;202;7;85;4;117;3
92;2020-S18;C;249;17;109;9;140;8
92;2020-S18;D;67;7;32;3;35;4
92;2020-S18;E;169;14;49;4;120;10
92;2020-S19;0;727;16;294;6;433;10
92;2020-S19;A;6;0;4;0;2;0
92;2020-S19;B;218;1;89;0;129;1
92;2020-S19;C;272;6;108;3;164;3
92;2020-S19;D;79;0;40;0;39;0
92;2020-S19;E;152;9;53;3;99;6
92;2020-S20;0;1200;49;450;13;750;36
92;2020-S20;A;45;1;27;0;18;1
92;2020-S20;B;426;9;164;1;262;8
92;2020-S20;C;391;15;136;5;255;10
92;2020-S20;D;130;3;60;1;70;2
92;2020-S20;E;208;21;63;6;145;15
92;2020-S21;0;881;24;357;14;524;10
92;2020-S21;A;56;0;32;0;24;0
92;2020-S21;B;322;4;139;2;183;2
92;2020-S21;C;253;4;92;2;161;2
92;2020-S21;D;92;2;45;1;47;1
92;2020-S21;E;156;14;49;9;107;5
93;2020-S11;0;25;7;9;3;16;4
93;2020-S11;A;0;0;0;0;0;0
93;2020-S11;B;15;2;6;1;9;1
93;2020-S11;C;6;3;1;1;5;2
93;2020-S11;D;1;0;0;0;1;0
93;2020-S11;E;3;2;2;1;1;1
93;2020-S12;0;374;194;148;83;226;111
93;2020-S12;A;2;0;1;0;1;0
93;2020-S12;B;149;58;42;16;107;42
93;2020-S12;C;134;76;57;33;77;43
93;2020-S12;D;44;31;26;20;18;11
93;2020-S12;E;45;29;22;14;23;15
93;2020-S13;0;997;523;401;230;596;293
93;2020-S13;A;10;2;5;0;5;2
93;2020-S13;B;399;162;110;39;289;123
93;2020-S13;C;362;203;155;91;207;112
93;2020-S13;D;89;64;60;44;29;20
93;2020-S13;E;137;92;71;56;66;36
93;2020-S14;0;1363;619;494;229;869;390
93;2020-S14;A;4;0;3;0;1;0
93;2020-S14;B;540;196;148;48;392;148
93;2020-S14;C;461;205;171;76;290;129
93;2020-S14;D;140;79;85;47;55;32
93;2020-S14;E;214;138;86;58;128;80
93;2020-S15;0;1464;513;455;176;1009;337
93;2020-S15;A;10;2;7;1;3;1
93;2020-S15;B;509;133;145;40;364;93
93;2020-S15;C;474;145;152;52;322;93
93;2020-S15;D;119;58;59;32;60;26
93;2020-S15;E;350;174;92;51;258;123
93;2020-S16;0;1187;328;382;110;805;218
93;2020-S16;A;8;0;3;0;5;0
93;2020-S16;B;331;60;103;22;228;38
93;2020-S16;C;279;70;97;33;182;37
93;2020-S16;D;123;43;72;24;51;19
93;2020-S16;E;443;153;106;31;337;122
93;2020-S17;0;1163;229;331;63;832;166
93;2020-S17;A;2;0;1;0;1;0
93;2020-S17;B;340;53;90;11;250;42
93;2020-S17;C;366;55;101;16;265;39
93;2020-S17;D;105;20;54;8;51;12
93;2020-S17;E;349;101;85;28;264;73
93;2020-S18;0;409;37;159;10;250;27
93;2020-S18;A;3;0;2;0;1;0
93;2020-S18;B;174;20;53;6;121;14
93;2020-S18;C;157;11;64;1;93;10
93;2020-S18;D;44;3;23;2;21;1
93;2020-S18;E;30;3;16;1;14;2
93;2020-S19;0;513;27;217;11;296;16
93;2020-S19;A;12;0;4;0;8;0
93;2020-S19;B;183;9;81;5;102;4
93;2020-S19;C;219;12;90;5;129;7
93;2020-S19;D;49;0;20;0;29;0
93;2020-S19;E;50;6;22;1;28;5
93;2020-S20;0;568;23;250;12;318;11
93;2020-S20;A;26;0;14;0;12;0
93;2020-S20;B;233;11;97;4;136;7
93;2020-S20;C;199;11;85;8;114;3
93;2020-S20;D;61;0;28;0;33;0
93;2020-S20;E;47;1;25;0;22;1
93;2020-S21;0;498;13;201;7;297;6
93;2020-S21;A;20;0;8;0;12;0
93;2020-S21;B;211;7;81;3;130;4
93;2020-S21;C;162;3;67;3;95;0
93;2020-S21;D;50;0;25;0;25;0
93;2020-S21;E;55;3;20;1;35;2
94;2020-S11;0;12;2;4;1;8;1
94;2020-S11;A;0;0;0;0;0;0
94;2020-S11;B;3;0;2;0;1;0
94;2020-S11;C;3;1;0;0;3;1
94;2020-S11;D;2;1;2;1;0;0
94;2020-S11;E;4;0;0;0;4;0
94;2020-S12;0;121;55;43;20;78;35
94;2020-S12;A;0;0;0;0;0;0
94;2020-S12;B;52;20;18;8;34;12
94;2020-S12;C;45;21;18;8;27;13
94;2020-S12;D;9;5;2;1;7;4
94;2020-S12;E;15;9;5;3;10;6
94;2020-S13;0;754;315;287;118;467;197
94;2020-S13;A;9;0;3;0;6;0
94;2020-S13;B;291;116;86;29;205;87
94;2020-S13;C;251;100;92;33;159;67
94;2020-S13;D;78;25;53;17;25;8
94;2020-S13;E;125;74;53;39;72;35
94;2020-S14;0;1235;463;454;182;781;281
94;2020-S14;A;15;2;10;2;5;0
94;2020-S14;B;462;132;146;49;316;83
94;2020-S14;C;448;163;165;68;283;95
94;2020-S14;D;106;44;57;25;49;19
94;2020-S14;E;203;122;75;38;128;84
94;2020-S15;0;1287;448;414;157;873;291
94;2020-S15;A;20;1;9;1;11;0
94;2020-S15;B;391;88;131;31;260;57
94;2020-S15;C;378;136;121;49;257;87
94;2020-S15;D;114;42;52;20;62;22
94;2020-S15;E;383;181;101;56;282;125
94;2020-S16;0;1052;230;348;70;704;160
94;2020-S16;A;5;0;3;0;2;0
94;2020-S16;B;314;54;117;22;197;32
94;2020-S16;C;229;47;84;17;145;30
94;2020-S16;D;85;15;42;6;43;9
94;2020-S16;E;417;114;100;25;317;89
94;2020-S17;0;1362;158;410;55;952;103
94;2020-S17;A;11;0;3;0;8;0
94;2020-S17;B;383;35;122;13;261;22
94;2020-S17;C;357;35;133;19;224;16
94;2020-S17;D;101;17;47;8;54;9
94;2020-S17;E;509;71;105;15;404;56
94;2020-S18;0;694;56;244;19;450;37
94;2020-S18;A;6;1;3;1;3;0
94;2020-S18;B;207;18;72;9;135;9
94;2020-S18;C;210;14;80;3;130;11
94;2020-S18;D;55;3;29;2;26;1
94;2020-S18;E;214;20;59;4;155;16
94;2020-S19;0;438;25;164;9;274;16
94;2020-S19;A;12;0;6;0;6;0
94;2020-S19;B;160;7;69;3;91;4
94;2020-S19;C;148;3;51;1;97;2
94;2020-S19;D;49;5;15;3;34;2
94;2020-S19;E;68;10;22;2;46;8
94;2020-S20;0;1020;36;390;7;630;29
94;2020-S20;A;29;0;9;0;20;0
94;2020-S20;B;395;7;160;2;235;5
94;2020-S20;C;328;8;133;2;195;6
94;2020-S20;D;85;0;34;0;51;0
94;2020-S20;E;182;21;53;3;129;18
94;2020-S21;0;582;27;235;6;347;21
94;2020-S21;A;25;0;14;0;11;0
94;2020-S21;B;231;4;104;2;127;2
94;2020-S21;C;163;1;59;0;104;1
94;2020-S21;D;59;3;28;0;31;3
94;2020-S21;E;103;19;29;4;74;15
95;2020-S11;0;277;71;102;35;175;36
95;2020-S11;A;22;1;11;1;11;0
95;2020-S11;B;109;22;30;10;79;12
95;2020-S11;C;88;31;27;13;61;18
95;2020-S11;D;28;11;20;8;8;3
95;2020-S11;E;30;6;14;3;16;3
95;2020-S12;0;839;369;340;168;499;201
95;2020-S12;A;24;2;17;2;7;0
95;2020-S12;B;316;106;81;29;235;77
95;2020-S12;C;294;150;117;67;177;83
95;2020-S12;D;97;62;68;42;29;20
95;2020-S12;E;108;49;57;28;51;21
95;2020-S13;0;943;480;364;214;579;266
95;2020-S13;A;27;8;19;6;8;2
95;2020-S13;B;384;163;98;52;286;111
95;2020-S13;C;320;185;131;84;189;101
95;2020-S13;D;91;59;61;41;30;18
95;2020-S13;E;121;65;55;31;66;34
95;2020-S14;0;844;342;340;146;504;196
95;2020-S14;A;17;2;10;1;7;1
95;2020-S14;B;325;112;100;30;225;82
95;2020-S14;C;278;112;115;57;163;55
95;2020-S14;D;82;42;52;28;30;14
95;2020-S14;E;142;74;63;30;79;44
95;2020-S15;0;666;241;222;82;444;159
95;2020-S15;A;3;0;0;0;3;0
95;2020-S15;B;214;64;57;15;157;49
95;2020-S15;C;212;66;79;25;133;41
95;2020-S15;D;53;22;30;12;23;10
95;2020-S15;E;184;89;56;30;128;59
95;2020-S16;0;798;180;270;57;528;123
95;2020-S16;A;5;1;3;1;2;0
95;2020-S16;B;217;25;71;5;146;20
95;2020-S16;C;275;81;92;30;183;51
95;2020-S16;D;54;13;25;6;29;7
95;2020-S16;E;244;60;77;15;167;45
95;2020-S17;0;815;91;250;36;565;55
95;2020-S17;A;9;0;4;0;5;0
95;2020-S17;B;226;15;43;2;183;13
95;2020-S17;C;231;26;87;15;144;11
95;2020-S17;D;59;10;33;6;26;4
95;2020-S17;E;286;39;83;13;203;26
95;2020-S18;0;368;32;104;8;264;24
95;2020-S18;A;7;0;4;0;3;0
95;2020-S18;B;145;13;36;3;109;10
95;2020-S18;C;135;12;34;4;101;8
95;2020-S18;D;21;2;10;0;11;2
95;2020-S18;E;57;5;19;1;38;4
95;2020-S19;0;354;27;138;8;216;19
95;2020-S19;A;3;0;1;0;2;0
95;2020-S19;B;136;12;48;5;88;7
95;2020-S19;C;126;5;50;1;76;4
95;2020-S19;D;34;3;22;1;12;2
95;2020-S19;E;53;7;15;1;38;6
95;2020-S20;0;514;28;203;10;311;18
95;2020-S20;A;21;0;9;0;12;0
95;2020-S20;B;216;2;99;2;117;0
95;2020-S20;C;167;6;64;3;103;3
95;2020-S20;D;38;6;15;3;23;3
95;2020-S20;E;71;14;16;2;55;12
95;2020-S21;0;404;7;173;4;231;3
95;2020-S21;A;24;0;11;0;13;0
95;2020-S21;B;156;3;65;2;91;1
95;2020-S21;C;132;2;59;1;73;1
95;2020-S21;D;46;0;19;0;27;0
95;2020-S21;E;46;2;19;1;27;1
971;2020-S11;0;0;0;0;0;0;0
971;2020-S11;A;0;0;0;0;0;0
971;2020-S11;B;0;0;0;0;0;0
971;2020-S11;C;0;0;0;0;0;0
971;2020-S11;D;0;0;0;0;0;0
971;2020-S11;E;0;0;0;0;0;0
971;2020-S12;0;2;1;2;1;0;0
971;2020-S12;A;0;0;0;0;0;0
971;2020-S12;B;1;0;1;0;0;0
971;2020-S12;C;0;0;0;0;0;0
971;2020-S12;D;0;0;0;0;0;0
971;2020-S12;E;1;1;1;1;0;0
971;2020-S13;0;8;3;1;0;7;3
971;2020-S13;A;0;0;0;0;0;0
971;2020-S13;B;4;1;0;0;4;1
971;2020-S13;C;2;1;1;0;1;1
971;2020-S13;D;2;1;0;0;2;1
971;2020-S13;E;0;0;0;0;0;0
971;2020-S14;0;13;8;2;2;11;6
971;2020-S14;A;0;0;0;0;0;0
971;2020-S14;B;4;4;1;1;3;3
971;2020-S14;C;4;1;1;1;3;0
971;2020-S14;D;4;2;0;0;4;2
971;2020-S14;E;1;1;0;0;1;1
971;2020-S15;0;4;0;0;0;4;0
971;2020-S15;A;0;0;0;0;0;0
971;2020-S15;B;3;0;0;0;3;0
971;2020-S15;C;0;0;0;0;0;0
971;2020-S15;D;1;0;0;0;1;0
971;2020-S15;E;0;0;0;0;0;0
971;2020-S16;0;4;1;1;0;3;1
971;2020-S16;A;0;0;0;0;0;0
971;2020-S16;B;3;1;0;0;3;1
971;2020-S16;C;1;0;1;0;0;0
971;2020-S16;D;0;0;0;0;0;0
971;2020-S16;E;0;0;0;0;0;0
971;2020-S17;0;7;1;3;0;4;1
971;2020-S17;A;0;0;0;0;0;0
971;2020-S17;B;5;1;2;0;3;1
971;2020-S17;C;0;0;0;0;0;0
971;2020-S17;D;1;0;1;0;0;0
971;2020-S17;E;1;0;0;0;1;0
971;2020-S18;0;3;1;0;0;3;1
971;2020-S18;A;0;0;0;0;0;0
971;2020-S18;B;1;0;0;0;1;0
971;2020-S18;C;1;0;0;0;1;0
971;2020-S18;D;0;0;0;0;0;0
971;2020-S18;E;1;1;0;0;1;1
971;2020-S19;0;5;1;2;0;3;1
971;2020-S19;A;0;0;0;0;0;0
971;2020-S19;B;2;1;0;0;2;1
971;2020-S19;C;1;0;0;0;1;0
971;2020-S19;D;2;0;2;0;0;0
971;2020-S19;E;0;0;0;0;0;0
971;2020-S20;0;2;1;0;0;2;1
971;2020-S20;A;0;0;0;0;0;0
971;2020-S20;B;0;0;0;0;0;0
971;2020-S20;C;0;0;0;0;0;0
971;2020-S20;D;0;0;0;0;0;0
971;2020-S20;E;2;1;0;0;2;1
971;2020-S21;0;3;0;1;0;2;0
971;2020-S21;A;1;0;1;0;0;0
971;2020-S21;B;2;0;0;0;2;0
971;2020-S21;C;0;0;0;0;0;0
971;2020-S21;D;0;0;0;0;0;0
971;2020-S21;E;0;0;0;0;0;0
972;2020-S11;0;0;0;0;0;0;0
972;2020-S11;A;0;0;0;0;0;0
972;2020-S11;B;0;0;0;0;0;0
972;2020-S11;C;0;0;0;0;0;0
972;2020-S11;D;0;0;0;0;0;0
972;2020-S11;E;0;0;0;0;0;0
972;2020-S12;0;0;0;0;0;0;0
972;2020-S12;A;0;0;0;0;0;0
972;2020-S12;B;0;0;0;0;0;0
972;2020-S12;C;0;0;0;0;0;0
972;2020-S12;D;0;0;0;0;0;0
972;2020-S12;E;0;0;0;0;0;0
972;2020-S13;0;3;1;2;1;1;0
972;2020-S13;A;0;0;0;0;0;0
972;2020-S13;B;1;0;0;0;1;0
972;2020-S13;C;2;1;2;1;0;0
972;2020-S13;D;0;0;0;0;0;0
972;2020-S13;E;0;0;0;0;0;0
972;2020-S14;0;7;3;3;1;4;2
972;2020-S14;A;0;0;0;0;0;0
972;2020-S14;B;3;1;1;0;2;1
972;2020-S14;C;2;1;0;0;2;1
972;2020-S14;D;1;1;1;1;0;0
972;2020-S14;E;1;0;1;0;0;0
972;2020-S15;0;5;0;4;0;1;0
972;2020-S15;A;0;0;0;0;0;0
972;2020-S15;B;3;0;2;0;1;0
972;2020-S15;C;1;0;1;0;0;0
972;2020-S15;D;0;0;0;0;0;0
972;2020-S15;E;1;0;1;0;0;0
972;2020-S16;0;4;1;1;0;3;1
972;2020-S16;A;0;0;0;0;0;0
972;2020-S16;B;1;0;0;0;1;0
972;2020-S16;C;1;0;0;0;1;0
972;2020-S16;D;1;1;0;0;1;1
972;2020-S16;E;1;0;1;0;0;0
972;2020-S17;0;3;0;1;0;2;0
972;2020-S17;A;0;0;0;0;0;0
972;2020-S17;B;3;0;1;0;2;0
972;2020-S17;C;0;0;0;0;0;0
972;2020-S17;D;0;0;0;0;0;0
972;2020-S17;E;0;0;0;0;0;0
972;2020-S18;0;2;0;1;0;1;0
972;2020-S18;A;0;0;0;0;0;0
972;2020-S18;B;1;0;0;0;1;0
972;2020-S18;C;0;0;0;0;0;0
972;2020-S18;D;1;0;1;0;0;0
972;2020-S18;E;0;0;0;0;0;0
972;2020-S19;0;2;1;0;0;2;1
972;2020-S19;A;0;0;0;0;0;0
972;2020-S19;B;2;1;0;0;2;1
972;2020-S19;C;0;0;0;0;0;0
972;2020-S19;D;0;0;0;0;0;0
972;2020-S19;E;0;0;0;0;0;0
972;2020-S20;0;3;0;2;0;1;0
972;2020-S20;A;0;0;0;0;0;0
972;2020-S20;B;2;0;2;0;0;0
972;2020-S20;C;1;0;0;0;1;0
972;2020-S20;D;0;0;0;0;0;0
972;2020-S20;E;0;0;0;0;0;0
972;2020-S21;0;0;0;0;0;0;0
972;2020-S21;A;0;0;0;0;0;0
972;2020-S21;B;0;0;0;0;0;0
972;2020-S21;C;0;0;0;0;0;0
972;2020-S21;D;0;0;0;0;0;0
972;2020-S21;E;0;0;0;0;0;0
973;2020-S11;0;0;0;0;0;0;0
973;2020-S11;A;0;0;0;0;0;0
973;2020-S11;B;0;0;0;0;0;0
973;2020-S11;C;0;0;0;0;0;0
973;2020-S11;D;0;0;0;0;0;0
973;2020-S11;E;0;0;0;0;0;0
973;2020-S12;0;8;0;5;0;3;0
973;2020-S12;A;2;0;2;0;0;0
973;2020-S12;B;4;0;1;0;3;0
973;2020-S12;C;0;0;0;0;0;0
973;2020-S12;D;1;0;1;0;0;0
973;2020-S12;E;1;0;1;0;0;0
973;2020-S13;0;4;2;0;0;4;2
973;2020-S13;A;0;0;0;0;0;0
973;2020-S13;B;2;1;0;0;2;1
973;2020-S13;C;1;0;0;0;1;0
973;2020-S13;D;1;1;0;0;1;1
973;2020-S13;E;0;0;0;0;0;0
973;2020-S14;0;3;0;1;0;2;0
973;2020-S14;A;0;0;0;0;0;0
973;2020-S14;B;2;0;0;0;2;0
973;2020-S14;C;0;0;0;0;0;0
973;2020-S14;D;1;0;1;0;0;0
973;2020-S14;E;0;0;0;0;0;0
973;2020-S15;0;11;2;6;2;5;0
973;2020-S15;A;0;0;0;0;0;0
973;2020-S15;B;4;1;1;1;3;0
973;2020-S15;C;6;1;4;1;2;0
973;2020-S15;D;1;0;1;0;0;0
973;2020-S15;E;0;0;0;0;0;0
973;2020-S16;0;0;0;0;0;0;0
973;2020-S16;A;0;0;0;0;0;0
973;2020-S16;B;0;0;0;0;0;0
973;2020-S16;C;0;0;0;0;0;0
973;2020-S16;D;0;0;0;0;0;0
973;2020-S16;E;0;0;0;0;0;0
973;2020-S17;0;4;0;3;0;1;0
973;2020-S17;A;1;0;0;0;1;0
973;2020-S17;B;1;0;1;0;0;0
973;2020-S17;C;2;0;2;0;0;0
973;2020-S17;D;0;0;0;0;0;0
973;2020-S17;E;0;0;0;0;0;0
973;2020-S18;0;2;0;0;0;2;0
973;2020-S18;A;1;0;0;0;1;0
973;2020-S18;B;1;0;0;0;1;0
973;2020-S18;C;0;0;0;0;0;0
973;2020-S18;D;0;0;0;0;0;0
973;2020-S18;E;0;0;0;0;0;0
973;2020-S19;0;2;0;1;0;1;0
973;2020-S19;A;0;0;0;0;0;0
973;2020-S19;B;1;0;1;0;0;0
973;2020-S19;C;1;0;0;0;1;0
973;2020-S19;D;0;0;0;0;0;0
973;2020-S19;E;0;0;0;0;0;0
973;2020-S20;0;1;0;0;0;1;0
973;2020-S20;A;0;0;0;0;0;0
973;2020-S20;B;0;0;0;0;0;0
973;2020-S20;C;0;0;0;0;0;0
973;2020-S20;D;0;0;0;0;0;0
973;2020-S20;E;1;0;0;0;1;0
973;2020-S21;0;0;0;0;0;0;0
973;2020-S21;A;0;0;0;0;0;0
973;2020-S21;B;0;0;0;0;0;0
973;2020-S21;C;0;0;0;0;0;0
973;2020-S21;D;0;0;0;0;0;0
973;2020-S21;E;0;0;0;0;0;0
974;2020-S11;0;0;0;0;0;0;0
974;2020-S11;A;0;0;0;0;0;0
974;2020-S11;B;0;0;0;0;0;0
974;2020-S11;C;0;0;0;0;0;0
974;2020-S11;D;0;0;0;0;0;0
974;2020-S11;E;0;0;0;0;0;0
974;2020-S12;0;0;0;0;0;0;0
974;2020-S12;A;0;0;0;0;0;0
974;2020-S12;B;0;0;0;0;0;0
974;2020-S12;C;0;0;0;0;0;0
974;2020-S12;D;0;0;0;0;0;0
974;2020-S12;E;0;0;0;0;0;0
974;2020-S13;0;1;0;1;0;0;0
974;2020-S13;A;0;0;0;0;0;0
974;2020-S13;B;0;0;0;0;0;0
974;2020-S13;C;0;0;0;0;0;0
974;2020-S13;D;0;0;0;0;0;0
974;2020-S13;E;1;0;1;0;0;0
974;2020-S14;0;2;0;1;0;1;0
974;2020-S14;A;0;0;0;0;0;0
974;2020-S14;B;1;0;0;0;1;0
974;2020-S14;C;1;0;1;0;0;0
974;2020-S14;D;0;0;0;0;0;0
974;2020-S14;E;0;0;0;0;0;0
974;2020-S15;0;1;0;1;0;0;0
974;2020-S15;A;0;0;0;0;0;0
974;2020-S15;B;1;0;1;0;0;0
974;2020-S15;C;0;0;0;0;0;0
974;2020-S15;D;0;0;0;0;0;0
974;2020-S15;E;0;0;0;0;0;0
974;2020-S16;0;4;1;2;0;2;1
974;2020-S16;A;0;0;0;0;0;0
974;2020-S16;B;2;0;1;0;1;0
974;2020-S16;C;2;1;1;0;1;1
974;2020-S16;D;0;0;0;0;0;0
974;2020-S16;E;0;0;0;0;0;0
974;2020-S17;0;3;0;1;0;2;0
974;2020-S17;A;0;0;0;0;0;0
974;2020-S17;B;3;0;1;0;2;0
974;2020-S17;C;0;0;0;0;0;0
974;2020-S17;D;0;0;0;0;0;0
974;2020-S17;E;0;0;0;0;0;0
974;2020-S18;0;1;0;0;0;1;0
974;2020-S18;A;0;0;0;0;0;0
974;2020-S18;B;1;0;0;0;1;0
974;2020-S18;C;0;0;0;0;0;0
974;2020-S18;D;0;0;0;0;0;0
974;2020-S18;E;0;0;0;0;0;0
974;2020-S19;0;3;0;1;0;2;0
974;2020-S19;A;0;0;0;0;0;0
974;2020-S19;B;1;0;0;0;1;0
974;2020-S19;C;2;0;1;0;1;0
974;2020-S19;D;0;0;0;0;0;0
974;2020-S19;E;0;0;0;0;0;0
974;2020-S20;0;2;0;2;0;0;0
974;2020-S20;A;0;0;0;0;0;0
974;2020-S20;B;0;0;0;0;0;0
974;2020-S20;C;1;0;1;0;0;0
974;2020-S20;D;1;0;1;0;0;0
974;2020-S20;E;0;0;0;0;0;0
974;2020-S21;0;2;0;1;0;1;0
974;2020-S21;A;0;0;0;0;0;0
974;2020-S21;B;0;0;0;0;0;0
974;2020-S21;C;1;0;1;0;0;0
974;2020-S21;D;1;0;0;0;1;0
974;2020-S21;E;0;0;0;0;0;0
976;2020-S11;0;0;0;0;0;0;0
976;2020-S11;A;0;0;0;0;0;0
976;2020-S11;B;0;0;0;0;0;0
976;2020-S11;C;0;0;0;0;0;0
976;2020-S11;D;0;0;0;0;0;0
976;2020-S11;E;0;0;0;0;0;0
976;2020-S12;0;0;0;0;0;0;0
976;2020-S12;A;0;0;0;0;0;0
976;2020-S12;B;0;0;0;0;0;0
976;2020-S12;C;0;0;0;0;0;0
976;2020-S12;D;0;0;0;0;0;0
976;2020-S12;E;0;0;0;0;0;0
976;2020-S13;0;2;1;1;0;1;1
976;2020-S13;A;0;0;0;0;0;0
976;2020-S13;B;1;1;0;0;1;1
976;2020-S13;C;1;0;1;0;0;0
976;2020-S13;D;0;0;0;0;0;0
976;2020-S13;E;0;0;0;0;0;0
976;2020-S14;0;0;0;0;0;0;0
976;2020-S14;A;0;0;0;0;0;0
976;2020-S14;B;0;0;0;0;0;0
976;2020-S14;C;0;0;0;0;0;0
976;2020-S14;D;0;0;0;0;0;0
976;2020-S14;E;0;0;0;0;0;0
976;2020-S15;0;0;0;0;0;0;0
976;2020-S15;A;0;0;0;0;0;0
976;2020-S15;B;0;0;0;0;0;0
976;2020-S15;C;0;0;0;0;0;0
976;2020-S15;D;0;0;0;0;0;0
976;2020-S15;E;0;0;0;0;0;0
976;2020-S16;0;0;0;0;0;0;0
976;2020-S16;A;0;0;0;0;0;0
976;2020-S16;B;0;0;0;0;0;0
976;2020-S16;C;0;0;0;0;0;0
976;2020-S16;D;0;0;0;0;0;0
976;2020-S16;E;0;0;0;0;0;0
976;2020-S17;0;0;0;0;0;0;0
976;2020-S17;A;0;0;0;0;0;0
976;2020-S17;B;0;0;0;0;0;0
976;2020-S17;C;0;0;0;0;0;0
976;2020-S17;D;0;0;0;0;0;0
976;2020-S17;E;0;0;0;0;0;0
976;2020-S18;0;0;0;0;0;0;0
976;2020-S18;A;0;0;0;0;0;0
976;2020-S18;B;0;0;0;0;0;0
976;2020-S18;C;0;0;0;0;0;0
976;2020-S18;D;0;0;0;0;0;0
976;2020-S18;E;0;0;0;0;0;0
976;2020-S19;0;0;0;0;0;0;0
976;2020-S19;A;0;0;0;0;0;0
976;2020-S19;B;0;0;0;0;0;0
976;2020-S19;C;0;0;0;0;0;0
976;2020-S19;D;0;0;0;0;0;0
976;2020-S19;E;0;0;0;0;0;0
976;2020-S20;0;1;0;0;0;1;0
976;2020-S20;A;0;0;0;0;0;0
976;2020-S20;B;1;0;0;0;1;0
976;2020-S20;C;0;0;0;0;0;0
976;2020-S20;D;0;0;0;0;0;0
976;2020-S20;E;0;0;0;0;0;0
976;2020-S21;0;1;0;0;0;1;0
976;2020-S21;A;0;0;0;0;0;0
976;2020-S21;B;1;0;0;0;1;0
976;2020-S21;C;0;0;0;0;0;0
976;2020-S21;D;0;0;0;0;0;0
976;2020-S21;E;0;0;0;0;0;0
